Fe Medina Ortega: Ràdio,Cadireta
Zeus Llesera Maruny: Televisor
Candela Mata Solé: Casa de nines,Guerrer amb espasa,Estoig,Cadireta,Gorro,Llibreta
Candela Mercadal Montroig: Disc de música,Ordinador
Joan Lozano Llabot: Puzzle,Guerrer amb espasa,Sabates,Nina rossa,Ràdio
Frederic March Raga: Televisor,Capsa de bombons,Torró,Cotxe,Conillet rosa
Joan Pinot Bonaterra: Llibre de dibuixos,Escacs,Capsa de bombons,Cowboy
Baldiri Gasull Marsany: Biberó,Ordinador,Cadireta
Fe Solé León: Ulleres de sol,Estoig
Homer Nogué Masolivé: Mocador de coll,Jaqueta,Corbata
Òscar Llorens Lluch: Caramels,Capsa de bombons,Llibreta,Arc i fletxes
Maria Matarodona Mascarell: Ulleres de sol,Caramels,Cowboy
Toni Masclans Junyent: Escacs,Còmic
Joan Llobet Vilamoll: Escacs,Cadireta,Estoig,Ràdio
Helena Llach Albiol: Llibre de dibuixos,Caramels,Sabates
Ernest Guilella Palop: Llibre de dibuixos,Nina morena,Guants,Corbata
Sergi Pallarol Montió: Bufanda,Mocador de coll,Retallable,Nina rossa,Llapissos
Enric Vinals Piñol: Televisor,Cowboy,Guerrer amb espasa,Còmic,Conillet rosa,Torró
Òscar Oliveras Agulla: Retallable,Estoig
Joaquim Pijoan Nogué: Puzzle,Llibreta,Manta,Os de peluix,Cadireta
Filomenu Maluquer Maurell: Nina morena,Joc de taula,Llibreta,Ràdio
Angela Mascarell Guardiola: Ulleres de sol,Puzzle,Mitxons,Calendari
Baldiri Paula Mont: Televisor,Rellotge,Corbata,Mocador de coll,Ràdio,Bufanda
Mireia Tubau Masclans: Caramels,Joc de taula,Conillet rosa,Jersei
Angela Jiménez Martell: Llibreta
Baldiri Puig Maurell: Ulleres de sol,Manta,Estoig,Jaqueta,Arc i fletxes
Mònica Iglesias Llort: Llibre,Disc de música
Susanna Pallarol Lloberes: Capsa de bombons,Sabates
Rufo Ubach Hosta: Torró,Estoig
Pep Maruny Marti: Llibreta
Sònia Llobet Peret: Escacs,Mitxons,Disc de música
Rufo Boix Lacalle: Bufanda,Conillet rosa
Felicitat Luque Macrané: Televisor,Llapissos,Sabates,Ràdio,Nina morena,Cotxe
Paco Llesera Gual: Ulleres de sol
Maria Lluisa Gutierrez Giménez: Llibre de dibuixos,Mocador de coll,Capsa de bombons,Llibreta
Sam Mach Taberner: Mocador de coll
Gerard Piqueras Perez: Escacs,Caramels,Guants,Corbata
Víctor Ubach Matamala: Mocador de coll
Filomenu Manzano Juanola: Guants,Sabates
Maria Mercadal Pey: Ordinador,Cotxe
Maria Lluisa Maymó Peret: Televisor,Capsa de bombons,Jersei,Cotxe,Nina morena
Susanna Mayans Llorens: Còmic,Ordinador
Mònica Negre Llesera: Escacs,Llibre,Manta
Lluis Macià Jara: Capsa de bombons
Cristian Bonaterra Lladó: Llapissos,Jaqueta,Guerrer amb espasa,Ràdio,Calendari,Gorro
Toni Julià Solé: Cotxe
Mireia Guimerà Jaques: Mitxons
Bernat Pinyas Gual: Mòbil,Disc de música,Jersei
Pol Medrano Mundó: Bicicleta,Guerrer amb espasa,Cotxe elèctric,Nina rossa,Cowboy
Sam Llorente Fernàndez: Gorro,Llapissos,Disc de música
Frances Iglesias Llabot: Cotxe elèctric,Ràdio
Merce Puig Guardiola: Llapissos,Rellotge,Ràdio
Pepa Llach Guirao: Llibre de dibuixos,Escacs,Ordinador,Cotxe,Ràdio
Helena Llorente Jornet: Retallable,Nina bebé,Còmic,Bufanda
Rufo Armengol Ingla: Cadireta
Maria Lluisa Malla Lacalle: Gorro,Caramels,Rellotge
Queralt Cardona Pericas: Galetes,Capsa de bombons,Cowboy,Nina rossa,Arc i fletxes
Toni Piqueras Boix: Manta,Mocador de coll,Mitjons,Bufanda,Galetes,Ulleres de sol
Lluis Bonastre Albí: Ordinador
Toni  Alcoberro: Capsa de bombons,Manta,Guerrer amb espasa,Conillet rosa,Torró,Disc de música
Marta Guasch Guasch: Llibre,Capsa de bombons,Calendari,Cotxe elèctric
Quim Maruny Nogué: Conillet rosa,Gorro,Torró,Mitjons,Nina rossa
Gerard Huguet Tió: Os de peluix,Joc de taula
Joan Josep Giménez Llenas: Llibre,Llibreta
Diego Armengol : Galetes,Cadireta
Susanna Pitarch Llansana: Manta,Llibre de dibuixos,Mocador de coll,Sabates,Ràdio,Jersei
Lluis Monells Hernández: Llibre,Capsa de bombons,Disc de música,Arc i fletxes
Queralt Pellicer Masvidal: Capsa de bombons,Cowboy
Susanna Matute Pelegrí: Arc i fletxes
Víctor Agulla Leal: Llibreta,Llibre de dibuixos,Còmic,Calendari,Cotxe elèctric
Rufo Mula Luque: Escacs,Mòbil,Mitjons
Lluis Guixà Gasull: Ordinador
Òscar Mercadé Pijoan: Cotxe elèctric
Anna Sonet Masclans: Puzzle,Ràdio
Fe Pelayo Llobet: Gorro,Capsa de bombons
Merce Jodar Rodríguez: Llibreta,Disc de música
Zeus Navajas : Nina bebé,Arc i fletxes,Ràdio
Òscar Morral Jaques: Llapissos,Corbata,Mòbil,Mitxons,Nina morena,Gorro
Toni Brunyol Vives: Llibre,Nina bebé,Colònia,Capsa de bombons,Corbata
Maria Lluisa Moron Páramo: Televisor,Bossa de mà,Cotxe,Os de peluix,Llapissos
Susanna Pastoret Alemany: Escacs,Mitxons,Cotxe
Bernat Pallarol Marcet: Televisor,Llibreta
David Maymó Pericas: Caramels,Mitxons
Anna Serra Peret: Llibre,Bufanda,Jersei
Marti Juanola Rey: Gorro,Capsa de bombons,Guants,Casa de nines
Lluis Mayné Guardiola: Llibre de dibuixos
Quim Messegué Jodar: Televisor,Guerrer amb espasa,Jersei,Ràdio
Candela Lara León: Mòbil,Nina morena,Mocador de coll
Zeus Lara Masdevall: Mitxons
Maria Jorba Mascarell: Estoig,Espasa de fusta,Cotxe,Disc de música
Helena Lloris Codina: Televisor,Llibreta,Espasa de fusta
Marti Masdevall Mayné: Gorro,Caramels,Cotxe elèctric,Cotxe
Pepa Llauradó Margalef: Cotxe elèctric,Calendari
Marti Puig Mercadal: Manta,Casa de nines,Guants,Conillet rosa,Ràdio
Josep Isern Linares: Ordinador,Arc i fletxes
Jean Bonaterra Pascal: Guerrer amb espasa,Cotxe,Cowboy
Helena Giménez Macrané: Mitjons
Sam Parer Manyé: Mitxons,Espasa de fusta,Corbata,Nina rossa,Cadireta
Alfons Masachs Llanet: Arc i fletxes
Mònica Marín Llauradó: Cotxe elèctric,Guants,Corbata,Sabates
Iu Pinot Pedrol: Escacs,Retallable,Nina rossa,Arc i fletxes
Manel Guimerà Masclans: Televisor,Puzzle,Calendari,Llibreta,Disc de música,Os de peluix
Joan Maurell Mayné: Ulleres de sol,Jaqueta
Aina Serra Alba: Televisor,Llibreta,Manta,Disc de música,Corbata
Felicitat Marcet Mayans: Retallable,Mòbil,Mocador de coll,Jaqueta,Tren
Antonia Marlés Pujol: Galetes,Televisor
Marti Masolivé Latre: Os de peluix
Maria Taberner González: Ordinador,Jersei
Met Orobitg Montroig: Colònia,Estoig
Antonia Hom Paret: Retallable
Paco Manyé Taberner: Televisor,Capsa de bombons,Biberó,Arc i fletxes,Casa de nines
Pepa Guardiola Pallarol: Retallable,Llibreta
Joan Pelayo Murga: Televisor,Torró,Jaqueta,Estoig
Queralt Iglesias Marot: Escacs
Diego Mula Roure: Televisor,Bufanda,Ràdio,Os de peluix,Ulleres de sol
Mònica Llabot Llobet: Conillet rosa
Joanot Maurell Orobitg: Llibre,Televisor,Bufanda
Cesc Marlés Manzano: Llibre,Retallable,Sabons,Nina rossa
Mònica Cardona Hom: Bufanda,Còmic,Cowboy
Queralt Montràs Páramo: Televisor,Conillet rosa
Iu Pi Pericas: Ulleres de sol,Cadireta
Iu Lacalle Guilella: Nina rossa
Charly Juvany Navajas: Sabons,Joc de taula
Charly Munné Gasull: Sabates
Didac Jorba Orobitg: Sabons
Anna Laborda Tubau: Llibre,Llapissos,Mitxons,Llibre de dibuixos,Guerrer amb espasa,Calendari
Bernat Llorente Mayans: Corbata,Guerrer amb espasa,Guants,Escacs,Ulleres de sol,Llibreta
Joanot Pastoret Bonastre: Capsa de bombons,Os de peluix
Pitu Marlés Guirao: Corbata,Llibre de dibuixos,Mòbil,Guants,Sabates,Capsa de bombons
Marti Magrinyà Mula: Nina bebé,Colònia,Nina rossa,Os de peluix
Frances Codina Agulla: Mòbil,Rellotge,Corbata,Bicicleta
Pere Platja Ordeig: Bicicleta,Cadireta
Ernest Mallafré Platja: Bufanda,Puzzle,Jaqueta,Cotxe,Cowboy
Daniel Icart Ricart: Retallable,Llapissos,Manta,Disc de música,Sabates
Queralt Jornet Moya: Disc de música
Maria Lluisa Pijoan Latre: Sabates
Marti Marot Ruiz: Llibre,Arc i fletxes,Guants,Cotxe,Cowboy
Filomenu Viu Parer: Sabates,Llibreta,Corbata,Calendari,Cowboy
Filomenu Llorente Puig: Conillet rosa
Mònica Petit Marcu: Nina rossa
Alfons Llatser Piñol: Retallable
Lluis Pi Alba: Bufanda,Ulleres de sol,Joc de taula,Disc de música,Calendari
Ernest Marqués Sabater: Escacs,Nina rossa
Mònica López Armengol: Mòbil,Guants,Estoig,Jersei,Cadireta
Cesc Platja Malla: Televisor,Ordinador
Merce Mata Marsà: Còmic,Cadireta
David Icart Ubach: Estoig,Casa de nines
Rufo Macrané Vinals: Gorro,Llapissos,Disc de música
Joan Brau Mascarell: Llibre de dibuixos,Nina morena
Jou Murga Pedreño: Llibre,Puzzle,Estoig,Sabates,Corbata
Felicitat Casajuana Bru: Llibre,Nina morena,Conillet rosa
Pitu Sonet Marcó: Llibreta,Estoig,Cowboy
Daniel Molas Masllorens: Puzzle,Capsa de bombons
Didac Guardiola Alcoberro: Llibre,Puzzle,Cotxe elèctric,Jersei
Daniel Mercadé Llanet: Bufanda,Nina morena,Corbata,Cotxe
Joaquim Maymó Piñol: Estoig
Charly Pericas Padrosa: Jersei
Jean Pericas Oliva: Llapissos
Angela Llorente Marot: Bufanda,Sabates,Capsa de bombons,Nina morena,Cotxe
Zeus Llauradó Monné: Llibre,Galetes,Llapissos,Calendari,Bossa de mà
Sònia Pericas Viu: Sabates
Jou Vives Montió: Guerrer amb espasa,Espasa de fusta,Nina bebé,Còmic,Jersei,Disc de música
Filomenu Llatser Mula: Llibre de dibuixos,Sabons,Manta
Pere Picanyol Junyent: Capsa de bombons,Mitxons,Manta
Cristian Boix Piferrer: Cotxe elèctric,Os de peluix
Cristian Manyé Masclans: Televisor,Mocador de coll,Mitxons,Nina rossa
Gerard Alemany Pont: Nina morena,Sabates
Paco Peret Jaques: Biberó
Antonia Peret Aubert: Mòbil,Rellotge,Biberó
Merce Soler Maurell: Guerrer amb espasa,Colònia,Cotxe
Miquel Hom Ortega: Estoig,Os de peluix
Pitu Paret Paradís: Bicicleta
Fe Olivella Marín: Retallable,Llibre,Sabons,Torró,Espasa de fusta
Joaquim Mínguez Llabot: Llapissos,Biberó,Guants,Disc de música
Òscar Mallafré Petit: Mòbil,Mitxons,Cadireta,Bossa de mà
Iu Roure Palacios: Caramels,Retallable,Guerrer amb espasa,Bicicleta,Cadireta,Ràdio
Joan Mayné Maluquer: Televisor,Mocador de coll,Llibre,Gorro,Bossa de mà
Mònica Jornet Padilla: Torró,Casa de nines,Arc i fletxes,Biberó,Ràdio
Jesus Marcó Mascarell: Llapissos,Guerrer amb espasa,Mocador de coll
Ot March Marsà: Llibre,Llapissos,Rellotge,Mòbil,Puzzle,Llibreta
Iu Llobet Isanta: Biberó,Casa de nines,Mitjons,Calendari,Arc i fletxes,Ulleres de sol
Joan Josep Mayans Maluquer: Sabons
Josep Antoni Pallejà Mundó: Televisor,Mocador de coll,Puzzle,Guants,Sabates,Capsa de bombons
Toni Sonet Boix: Llibre,Nina bebé,Cotxe elèctric,Os de peluix,Jersei
Paco Martell Marti: Ordinador
David Llenas Morral: Galetes,Biberó,Ordinador
Mònica Oliveras Masllorens: Nina bebé,Puzzle,Sabates,Jersei,Mòbil
Pep Llofriu Masdefiol: Guants,Mitjons
Felicitat Pastoret Fernàndez: Televisor,Nina bebé,Joc de taula,Cotxe
Enric Pujol Pujol: Jaqueta,Mitxons,Bicicleta,Còmic,Nina rossa,Torró
Met Mercadal Junyent: Cotxe elèctric,Cadireta
Jou Ricart Pont: Mòbil,Conillet rosa
Joan Mascarell Morillo: Llibre de dibuixos,Corbata
Alfons Llatser Taberner: Retallable,Caramels,Colònia,Corbata
Met Masdefiol Moya: Disc de música
David Juncosa Pascal: Televisor
Helena Juncosa Llansana: Estoig,Disc de música,Ordinador
Carles Gutierrez López: Rellotge,Disc de música,Nina rossa,Arc i fletxes
Met Maginet Lladó: Mocador de coll,Nina morena,Bossa de mà
Frederic Pijoan Pinot: Llibre de dibuixos,Biberó
Pepa Hernández Agulla: Mitxons,Caramels,Llibreta,Disc de música
Marta Llofriu Cardona: Puzzle,Jersei,Ràdio,Nina bebé,Còmic,Nina rossa
Carles Iranzo Marín: Llibre de dibuixos,Capsa de bombons,Nina rossa,Os de peluix
Anna Llesera Guasch: Conillet rosa
Sònia Platja Morillo: Colònia,Mitxons,Caramels
Frances Marcó Malla: Televisor,Mitxons,Arc i fletxes
Joan Mula Pou: Torró,Mocador de coll,Llibreta,Ordinador
Sam Paraire Marlés: Cotxe,Guerrer amb espasa,Estoig,Sabates
Pol Tubau Alcoberro: Còmic,Nina rossa
Sergi Lloberes Albí: Bicicleta,Cotxe,Arc i fletxes
Homer Paret Mula: Llibre de dibuixos,Mòbil
Jou Petit Oliveras: Manta,Ordinador
Quim Pesarrodona Vilamoll: Còmic,Sabates,Arc i fletxes
Felicitat Lladó Cardona: Llibre,Guerrer amb espasa,Guants,Conillet rosa,Bufanda,Colònia
Josep Antoni Jorba Ingla: Nina bebé,Disc de música
Jean Bonaterra Agulla: Sabons,Ordinador,Cadireta
Diego Jara Montià: Ràdio,Arc i fletxes
Met Ortega Terrats: Torró,Jersei
Pitu Moya Lacalle: Escacs,Mitxons,Còmic,Sabates,Tren
Pepa Iranzo Marqués: Guerrer amb espasa,Joc de taula
Zeus Padrosa Páramo: Bufanda,Nina bebé,Casa de nines,Llibreta,Bicicleta
Joan Josep Lluch Vilamoll: Escacs
Antonia Petrus Huguet: Televisor
Josep Antoni Parra Pericas: Ulleres de sol,Nina morena
Maria Lluisa Mula Hernández: Escacs,Mocador de coll,Colònia,Còmic,Rellotge
Joanot Pi Morral: Retallable,Llibre,Corbata
Pol Macià Nogué: Torró,Manta,Mocador de coll,Nina bebé,Gorro,Llibreta
Joaquim Raga Pesarrodona: Retallable,Conillet rosa,Jersei
Víctor Hom Ortega: Cowboy,Mitxons,Mitjons,Nina rossa,Ràdio
Jean Lacalle Pelegrí: Gorro,Mocador de coll,Llapissos
Carles Llofriu Pou: Gorro,Mitxons,Mitjons,Tren
Maria Juanola Icart: Gorro,Galetes,Capsa de bombons,Sabates,Casa de nines
Frances Manyé Hernández: Mòbil
Antonia Solé Guasch: Gorro,Sabates,Cotxe,Corbata
Enric Lara Lozano: Mocador de coll,Cotxe elèctric,Joc de taula,Os de peluix
Alfred Brunyol Llorente: Cowboy
Jesus Marlés Albí: Llibreta,Arc i fletxes
Felicitat Gutierrez Lluch: Llibre,Manta,Cadireta
Marti Aubert Pastoret: Llibre,Ulleres de sol,Mitxons,Espasa de fusta,Bicicleta
Felicitat Maymó Llatser: Puzzle,Torró,Arc i fletxes
Charly González Cardona: Televisor,Bossa de mà,Os de peluix
Bernat Jiménez Marsany: Disc de música
Cristian Pedrol Pinot: Gorro,Corbata
Joanot Monells Llauradó: Còmic
Maria Guevara Mayné: Bufanda,Mocador de coll,Colònia,Jaqueta,Sabates
Joan Junyent Brunyol: Disc de música,Cotxe
Mònica Llabot Mallafré: Nina bebé
Joan Josep Llesera Murga: Galetes
Mònica Lloris Mans: Llibreta,Televisor,Guerrer amb espasa,Cotxe elèctric,Conillet rosa
Rufo Not Llauradó: Capsa de bombons,Biberó,Espasa de fusta
Ernest Masvidal Mayans: Rellotge,Casa de nines,Estoig,Mitjons,Escacs,Cotxe elèctric
Jou Cardona Negre: Puzzle,Llibreta,Ordinador,Espasa de fusta,Mitjons
Mònica Marti Luque: Bicicleta,Capsa de bombons,Arc i fletxes,Jersei,Casa de nines
Frederic Jara Llabot: Retallable,Rellotge,Joc de taula,Os de peluix
Iu Lacalle Mercadal: Sabons
Jou Brunyol Pellicer: Còmic,Jersei
Ernest Malla Roure: Llapissos,Puzzle
Sònia Masllorens Pijoan: Llibre de dibuixos,Nina bebé
Víctor Pujol Olivella: Llibre,Llibreta,Estoig,Casa de nines
Antonia Mans Terrats: Calendari
Pitu Masdevall Jodar: Conillet rosa
Iu Laborda Mancho: Ordinador,Cotxe
Felicitat Llabot Masdefiol: Estoig,Ràdio
Alfred Platja Matamala: Llibre,Sabons,Casa de nines,Bossa de mà,Mitxons,Calendari
Joan Josep Hosta Hom: Tren,Mitxons,Nina morena,Còmic,Calendari,Escacs
Sergi Viu Bonaterra: Sabates,Cowboy
Aina Mínguez Mínguez: Colònia,Mitjons,Calendari,Tren
Joanot Oliveras Lladó: Torró
Maria Lluisa Hom Marlés: Torró,Estoig
Marti Tió Montià: Mocador de coll,Cotxe elèctric,Ràdio
Felicitat Lacalle Tubau: Llapissos,Caramels,Biberó,Corbata,Mitxons,Gorro
Carles Llenas Mach: Retallable,Mitxons,Arc i fletxes
Didac Guevara March: Gorro,Mocador de coll,Llibreta,Cotxe,Casa de nines
Bernarda Bru Moragues: Llibreta
Quim Masana Paladell: Televisor,Mòbil,Corbata
David Pallarol Pinot: Mitxons,Caramels,Guerrer amb espasa,Sabates
Pepa Pelayo Piqueras: Bossa de mà,Guerrer amb espasa,Jersei,Conillet rosa
Sam Paula Moragues: Galetes,Guants,Corbata,Ordinador
Maria Lluisa Jordana Llobet: Sabates
Maria Lluisa López Guasch: Casa de nines
Quim Pijoan Matarodona: Gorro,Calendari,Casa de nines
Diego Marqués Pelayo: Caramels,Sabates
Miquel Leal Icart: Gorro,Nina rossa,Cowboy
Xavier Murga Mercadal: Rellotge,Nina bebé,Bossa de mà,Sabates,Bufanda,Escacs
Sergi Llort Marcet: Llibre,Sabons,Colònia,Guants,Llibreta
Bernarda Navajas Pujol: Cadireta
Joan Llorente Marata: Llibre,Jaqueta,Mitjons,Joc de taula,Nina bebé,Colònia
Cesc Pelayo Jornet: Escacs,Bufanda,Guants,Cowboy
Cristian Isern Mercadé: Os de peluix,Rellotge,Joc de taula,Cotxe
Miquel Ubach Monné: Os de peluix,Nina bebé,Corbata,Nina rossa,Ràdio
Sònia Guvern Serra: Televisor,Mocador de coll,Biberó,Corbata,Espasa de fusta
Frederic  Murga: Manta,Corbata
Antonia Matarodona Piqueras: Nina bebé,Caramels,Estoig,Nina rossa,Bossa de mà
Frederic Brau Matamala: Caramels,Colònia,Llibre de dibuixos,Mitxons,Llibreta,Cotxe
Magda Llobet Palau: Retallable,Llapissos,Sabons,Televisor,Tren
Frances Lara Pastoret: Caramels,Guants,Sabates,Ràdio,Nina bebé,Bicicleta
Quim Malla Iranzo: Estoig,Torró,Nina morena,Os de peluix,Casa de nines
Max Llort Maruny: Llapissos,Mòbil,Espasa de fusta,Sabates,Cadireta,Colònia
Frances Manzano Marcu: Escacs
Antonia Macià Navajas: Sabons
Joaquim Messegué Alcoberro: Nina bebé,Caramels,Nina rossa
Homer Ibarra Montià: Disc de música,Joc de taula
Angela Huguet Marqués: Galetes,Nina bebé,Nina morena,Manta,Sabates
Jean Taberner Moragues: Calendari
Daniel Ricart Magrinyà: Bufanda,Guants,Bicicleta
Marti Mont Mula: Televisor
Sergi Masana Hosta: Guants,Bicicleta,Jaqueta,Cowboy
Pitu Junyent Manyé: Retallable,Jersei,Bicicleta
Felicitat Munné Llesera: Bicicleta,Jersei,Corbata,Sabates,Casa de nines
Ernest Guixà Navajas: Televisor,Caramels,Mitxons,Os de peluix
Pol Gasull Masachs: Ordinador
Joanot Boix Pericas: Biberó,Ràdio,Nina bebé,Còmic,Conillet rosa,Arc i fletxes
Charly Llanet Puig: Bufanda,Estoig,Nina rossa
Víctor Miravet Alemany: Colònia,Tren,Estoig,Llibreta,Arc i fletxes,Capsa de bombons
Filomenu Iglesias Pelegrí: Corbata
Pep Piñol Luque: Cowboy,Casa de nines,Nina bebé,Nina rossa,Arc i fletxes,Cotxe elèctric
Toni Montió Messegué: Manta,Cowboy
Joan Pou Tió: Televisor,Casa de nines,Bossa de mà,Guerrer amb espasa,Cotxe elèctric,Cotxe
Queralt Monells Pinot: Sabons,Casa de nines,Guants,Calendari,Cadireta,Cotxe
Didac Mayans Huguet: Retallable,Cotxe elèctric,Estoig,Disc de música
Toni Julià Iranzo: Cotxe elèctric
Joanot Pairó Mancho: Mitxons,Corbata,Llibreta
Bernarda Pedrol Guevara: Ulleres de sol,Colònia,Corbata,Cotxe elèctric,Bossa de mà
Sònia Mallafré Paret: Bufanda,Mocador de coll
Joan Manent Matute: Galetes,Nina bebé,Jaqueta,Mitjons,Arc i fletxes
Mireia Pesarrodona Pey: Estoig,Ordinador
Joan Padilla Masdevall: Rellotge,Mitxons
Pepa Mallafré Iranzo: Nina bebé,Cotxe elèctric,Casa de nines
Diego Paraire Mach: Bufanda,Ulleres de sol,Llibreta,Estoig,Nina rossa
Manel Margalef Pia: Manta,Sabates,Cadireta
Carles Llanet Mercadal: Corbata,Nina rossa
Merce Picanyol Sabater: Galetes,Arc i fletxes,Cadireta
Alfred Masana Rodríguez: Galetes,Ulleres de sol,Guants,Llapissos
Pitu Pou Albí: Puzzle
Alfred Sonet Oveja: Televisor,Corbata,Guerrer amb espasa,Estoig,Joc de taula,Còmic
Bernarda Palomera Masvidal: Mòbil,Capsa de bombons,Mitjons,Sabates,Llapissos
Baldiri Martell Alcoberro: Televisor,Llibre,Rellotge,Bicicleta
Filomenu Pujol Ricart: Mòbil,Sabons,Manta
Bernat Solé Jaques: Escacs,Retallable,Torró,Manta
Marta Ordeig González: Caramels,Colònia,Cowboy,Mitjons,Sabates,Cotxe elèctric
Cristian Negre Llatser: Estoig
Queralt Marín Llansana: Bossa de mà,Nina bebé,Ulleres de sol
Susanna Pallejà Brau: Galetes,Torró,Bicicleta,Cotxe,Arc i fletxes
Josep Paraire Terrats: Nina morena,Corbata
Daniel Peret Sabater: Mòbil,Nina bebé,Corbata,Mocador de coll
Felicitat Juvany Icart: Puzzle
Diego Paradís Murga: Bossa de mà,Nina morena,Guants
Iu Negre Medrano: Gorro,Guerrer amb espasa,Jaqueta
Jesus Llort Marlés: Còmic,Sabates
Pere Ricart Boix: Galetes,Mitxons,Os de peluix,Llibreta
Josep Antoni Just Paladell: Llibre,Sabons,Torró,Corbata,Joc de taula
Bernat Marot Masachs: Escacs,Gorro,Cowboy,Espasa de fusta,Bicicleta
Paco Medina Mitjavila: Llapissos,Biberó,Mòbil,Puzzle,Cadireta,Torró
Frederic Morillo Pedrol: Retallable,Mocador de coll,Llibre,Llibre de dibuixos,Bossa de mà
Anna Guixà Tió: Bufanda
Cristian Marsà Moya: Galetes,Nina bebé,Ulleres de sol,Estoig,Cowboy
Homer Guimerà Marcó: Mitxons,Llibreta,Sabates
Enric Monné Gasull: Llibre,Mocador de coll,Nina morena,Arc i fletxes,Disc de música,Cotxe
Rufo Montràs Pijoan: Joc de taula
Alfons Pijoan Soler: Llapissos,Cotxe,Espasa de fusta
Angela Lozano Mans: Conillet rosa,Jersei,Arc i fletxes
Joaquim Rodríguez Oliva: Llapissos,Manta,Mitxons,Sabates,Ràdio,Nina morena
Pol Palomera Not: Mocador de coll,Sabons,Jaqueta
Josep Antoni Isern Matarodona: Arc i fletxes,Escacs,Capsa de bombons,Nina morena,Bicicleta
Daniel Ortega Llofriu: Sabates
Bernat Montroig Brunyol: Estoig,Cotxe
Aina León Marcos: Caramels,Cowboy,Nina bebé,Cotxe,Bufanda,Os de peluix
Manel Malla Lozano: Llibre de dibuixos,Còmic,Corbata,Os de peluix,Casa de nines
Angela Pelegrí Tubau: Retallable,Gorro,Colònia,Capsa de bombons
Víctor Palau Peret: Caramels,Capsa de bombons
Antonia Piñol Magrinyà: Televisor,Mocador de coll,Guants,Conillet rosa,Ulleres de sol
Bernat Piqueras Páramo: Tren,Conillet rosa,Bicicleta
Òscar Pelayo Lloris: Llibre,Mòbil,Bicicleta,Estoig,Ràdio
Filomenu Maurell Masdefiol: Bicicleta
David Piferrer Platja: Nina bebé,Biberó,Jersei,Bicicleta
Josep Antoni Mayné Moya: Sabates
Cristian Pellicer Marcet: Televisor,Mòbil
Ernest Pi Parra: Llibre,Mitjons,Bicicleta
Didac Jorba Palau: Mocador de coll,Guants,Jersei,Cotxe,Tren
Víctor Maldonado Marqués: Espasa de fusta
Bernarda Marlés Ortega: Gorro,Cotxe,Corbata,Joc de taula,Cadireta
Pitu Mallafré Malé: Galetes,Mitxons,Conillet rosa,Calendari,Ràdio
Queralt Hosta Raga: Llibreta,Tren
Miquel Solé Iranzo: Cotxe elèctric,Conillet rosa
Ernest Mallafré Orobitg: Disc de música,Nina bebé,Joc de taula,Sabates,Tren
Joaquim Paraire Llobet: Llibreta,Ulleres de sol,Mitxons,Nina rossa,Arc i fletxes
Víctor Junyent Llabot: Llapissos,Corbata,Jersei,Estoig
Xavier Masana Mercadal: Llibre,Bossa de mà,Caramels,Cotxe,Bicicleta
Sònia Maymó Moragues: Corbata
Carles Lara Moron: Televisor
Manel Perez Masvidal: Caramels,Guerrer amb espasa,Espasa de fusta,Sabates,Arc i fletxes,Ulleres de sol
Gerard Tubau Olivella: Escacs,Caramels,Manta
Didac Pi Guasch: Nina bebé,Rellotge,Casa de nines
Angela Isanta López: Llibre,Puzzle,Ràdio
Pitu Parra Majós: Televisor,Llibre,Sabons,Biberó,Corbata,Mitjons
Josep Antoni Lluch Isern: Escacs
Marti Jaques Llofriu: Estoig,Conillet rosa
Helena Orobitg Marcó: Retallable,Mòbil,Torró,Ordinador,Arc i fletxes
Josep Moya Mundó: Bossa de mà,Rellotge,Llibreta
Queralt Piferrer Alba: Mocador de coll,Biberó
Joanot Mula Molas: Guants
Helena Lluch Mans: Llibre,Mòbil,Estoig,Nina rossa,Tren
Candela Pujol Medrano: Retallable,Guerrer amb espasa,Nina rossa,Calendari
Paco Paula : Llibre de dibuixos,Cotxe,Calendari
Quim Jodar Lladó: Ulleres de sol,Corbata,Sabates
Jean Armengol Palop: Disc de música
Magda Guixà Vives: Llibre,Colònia,Nina morena,Os de peluix
Miquel Lacalle Orobitg: Bufanda,Puzzle,Còmic,Espasa de fusta
Jou Mont Sonet: Colònia,Jersei,Ordinador,Cotxe elèctric
Víctor Negre Ortiz: Bossa de mà
Baldiri Huguet Jara: Ulleres de sol,Cotxe elèctric,Cowboy
Quim Roure Maldonado: Televisor,Puzzle,Nina morena,Sabates,Conillet rosa
Sònia Maurell Palau: Llibre,Casa de nines
Maria Malé Paret: Llibre de dibuixos
Jesus Llauradó Julià: Llibre de dibuixos,Mòbil,Mitxons,Bicicleta,Retallable,Os de peluix
Joanot Ricart Guilella: Nina bebé,Tren,Jaqueta,Cowboy
Candela Gual Marata: Llapissos
Antonia Pou Alba: Nina bebé,Llibreta,Estoig
Marta Ruiz Matarodona: Bufanda,Caramels,Nina morena,Jersei
Maria Guimerà Orobitg: Estoig,Bicicleta
Magda Guasch Pedreño: Ràdio,Sabates,Calendari,Cowboy
Lluis Piqueras Molas: Conillet rosa,Tren
Carles González Mont: Retallable,Conillet rosa
Toni Ricart Petrus: Llapissos,Mitjons,Nina rossa
Sam López Miravet: Manta
Alfred Juvany Ruiz: Llibre,Mitxons,Ràdio,Conillet rosa,Bufanda,Cotxe elèctric
Enric Pey Mancho: Torró,Ordinador,Nina morena,Ràdio
Lluis Marcó Marín: Torró
Candela Palop Moragues: Nina rossa
Joan Montràs González: Tren,Calendari,Cowboy
Zeus Marsany Pastoret: Corbata,Casa de nines,Nina rossa,Ulleres de sol,Colònia,Ordinador
Víctor Pelayo Llanet: Bufanda,Gorro,Còmic,Ordinador,Mòbil
Queralt Pastoret Guardiola: Mòbil,Nina morena,Tren,Ràdio
Joanot Petrus Jornet: Llibre de dibuixos,Ràdio
Mònica Ibarra Molas: Llibre,Puzzle,Cotxe
Queralt Marqués Maurell: Llibre,Llibre de dibuixos,Mitxons,Calendari,Ràdio
Miquel Linares Moragues: Llibre,Retallable,Biberó,Ordinador,Os de peluix
Max Jordana Gutierrez: Cowboy
Anna Maurell Lara: Mitxons,Joc de taula,Casa de nines
Manel Visent Hernández: Retallable
Miquel Montià Mitjavila: Sabons
Max Medina Palacios: Manta
Susanna Masachs Marsà: Cowboy
Alfons Solé Ubach: Bufanda,Llapissos,Rellotge,Guerrer amb espasa,Os de peluix
Angela Bonaterra Jiménez: Llibre de dibuixos,Escacs,Mitxons,Ràdio
Jou Oliveras González: Colònia
Queralt Lacalle Pou: Retallable
Carles Visent Mercadé: Gorro,Retallable,Llibre,Sabates
Magda Soler Majós: Bossa de mà,Llibreta
Jou Mundó Linares: Gorro,Cadireta
Queralt Tubau Lacalle: Galetes,Capsa de bombons,Tren
Gerard Alba Luque: Escacs,Ulleres de sol,Estoig,Llibre de dibuixos,Arc i fletxes
Miquel Ortega Hernández: Torró,Cotxe elèctric,Manta,Os de peluix
Alfons Llobet Just: Joc de taula,Tren
Zeus Maldonado Llatser: Televisor,Retallable,Guants,Galetes,Ordinador,Cotxe
Miquel Platja Palau: Retallable
Cristian Olivella Vinals: Llapissos,Puzzle,Torró,Mitjons,Calendari
Merce Pastoret Juvany: Nina bebé,Disc de música,Jersei
Frances Roure Mitjavila: Puzzle,Guants,Cadireta
Anna Taberner Moya: Torró,Cotxe elèctric,Corbata,Arc i fletxes
Enric Maginet Lladó: Guerrer amb espasa,Còmic,Nina rossa,Conillet rosa,Tren
Homer Pelayo Paladell: Manta,Joc de taula
Joanot Pujol Ortiz: Gorro,Torró,Espasa de fusta,Cadireta
Queralt Lara Lloberes: Còmic,Colònia,Manta,Conillet rosa,Sabates
Joan Josep Sonet León: Corbata,Guerrer amb espasa,Gorro,Nina morena,Bufanda,Ordinador
Marta Marata Agulla: Televisor,Llapissos,Cowboy,Nina bebé,Gorro,Ulleres de sol
Paco Mascarell Paraire: Sabons,Mitxons,Casa de nines,Bicicleta
Candela Peret Pelayo: Caramels
Ernest González Raga: Ulleres de sol,Ordinador,Ràdio
Maria Lluisa Albí Taberner: Còmic,Sabates,Arc i fletxes
Sergi Matute Matute: Gorro,Televisor,Mocador de coll,Mitxons,Nina bebé
Helena Platja Lozano: Sabons
Cristian Morillo Manyé: Galetes
Joaquim Casajuana Monné: Puzzle,Cotxe elèctric,Ordinador
Met Paret Bru: Galetes,Llibre,Jaqueta,Casa de nines
Mònica Maruny Pallejà: Tren,Mòbil,Estoig,Jersei,Sabates,Cotxe
Jean Martell Roure: Gorro,Llibre,Bufanda
Josep Munné Pia: Retallable,Bossa de mà
Sònia Jodar Marlés: Llibre,Tren,Jaqueta,Os de peluix,Cowboy
Alfons Parer Jodar: Retallable,Mitxons,Espasa de fusta,Sabates
Daniel Palacios Pastoret: Mòbil
Pol Pairó Bonastre: Llapissos
Max Marcet Brunyol: Escacs,Ulleres de sol,Colònia,Mitxons,Ràdio
Antonia Llesera Maurell: Retallable,Capsa de bombons,Còmic,Llibreta,Cadireta
Carles Llorente Mercadal: Rellotge,Cowboy,Retallable,Joc de taula,Llibre de dibuixos,Espasa de fusta
Sònia Masachs Bru: Llibre de dibuixos,Mocador de coll,Calendari,Tren
Helena Guvern Juncosa: Nina morena
Pepa Iranzo López: Tren,Espasa de fusta,Ràdio,Escacs,Colònia,Disc de música
Bernarda Pitarch Lloris: Mòbil,Corbata,Llapissos
Jou Gasull Moron: Nina bebé,Sabons,Llibreta
Pol Pedreño Guixà: Joc de taula
Marta Montroig Moron: Gorro,Caramels,Còmic,Mitjons,Cotxe
Jou Tubau Gasull: Sabons,Biberó,Rellotge,Jersei,Cowboy
Antonia Manzano Visent: Rellotge,Llibre de dibuixos,Jersei,Cadireta,Escacs,Llibreta
Josep Latre Gasull: Sabons,Casa de nines,Guants,Jersei,Ràdio
Jou Isanta Tió: Llibre,Sabons,Cowboy,Joc de taula,Cotxe elèctric,Ordinador
David Serra Marcet: Llibre,Nina rossa,Colònia,Ordinador,Espasa de fusta
Joan Josep Molas Malé: Llibre de dibuixos,Mitxons
Magda Platja Picanyol: Rellotge
Bernarda Taberner Macrané: Mòbil,Guants
Cesc Mercadal Maymó: Mitxons,Còmic,Joc de taula,Sabates,Cotxe elèctric
Marta Pallejà Guixà: Televisor,Jaqueta
Joan Huguet Maginet: Llibre,Galetes,Llibreta,Mitjons
Queralt Mascarell Guimerà: Gorro,Arc i fletxes
Miquel Masllorens Pericas: Llibre,Llapissos,Tren,Calendari,Cowboy
Maria Marcos Martell: Bufanda,Galetes
Candela Vinals Malé: Capsa de bombons,Puzzle,Còmic,Rellotge,Guerrer amb espasa
Max Brau Tió: Torró,Rellotge,Cotxe elèctric,Tren
Maria Manyé : Ordinador,Os de peluix
Didac Brunyol Manyé: Ulleres de sol,Còmic,Sabates
Jesus Llabot Monné: Llibre,Manta,Conillet rosa,Cowboy,Nina rossa,Jaqueta
Joanot Pedreño Morral: Mòbil,Llibreta,Bicicleta,Espasa de fusta,Nina bebé
Maria Llach Mancho: Televisor
Charly Aubert Fernàndez: Espasa de fusta
Met  Maruny: Nina rossa,Caramels,Puzzle,Sabates,Arc i fletxes
Víctor Llobet González: Mitxons,Cotxe
Ot Boix Guevara: Galetes,Bossa de mà,Jaqueta,Llapissos
Filomenu Pou Puig: Mòbil,Manta,Casa de nines
Paco Puig Codina: Llibre de dibuixos,Capsa de bombons,Llibre,Nina morena
Marta León Tió: Ulleres de sol
Sam González Gasull: Sabons,Colònia,Ordinador,Corbata
Didac Tubau Mancho: Corbata
Marta Masllorens Mayné: Bossa de mà,Sabons,Disc de música,Mòbil
Bernat Petit Macrané: Còmic,Nina morena,Espasa de fusta
Homer Bonaterra Navajas: Mòbil,Jersei,Corbata,Espasa de fusta
Víctor Messegué Masdevall: Llibre,Biberó
Sergi Pujol Pi: Disc de música
Magda Pelegrí Nogué: Bufanda
Fe Llesera Lara: Puzzle,Cotxe elèctric,Còmic,Mitjons,Conillet rosa
Didac Masana Icart: Televisor,Mitxons,Torró,Casa de nines
Òscar Piñol Pou: Sabons,Cowboy,Puzzle,Guerrer amb espasa,Còmic,Os de peluix
Pol Masclans Juncosa: Escacs,Cotxe elèctric,Calendari,Bicicleta
Bernat Maymó Montroig: Manta,Os de peluix
Joaquim Iranzo Llucià: Llibre de dibuixos
Marta Ricart Paladell: Sabons,Corbata,Mitjons
Daniel Isanta Rey: Mòbil,Llibreta,Ordinador,Os de peluix
Pepa Brau Picanyol: Puzzle,Os de peluix,Tren
Víctor Pi Jorba: Llibre,Mòbil,Llibreta
Daniel March Mayné: Disc de música
Joanot Sabater Pellicer: Gorro,Corbata,Os de peluix
Ernest Vives Vives: Sabons,Guerrer amb espasa,Bicicleta,Nina bebé,Nina morena,Os de peluix
Quim Mitjavila Marqués: Escacs,Ràdio,Corbata,Mitjons
Cesc Armengol González: Galetes,Retallable,Disc de música
Frances Munné Solé: Cotxe elèctric
Bernat Pastoret Icart: Conillet rosa,Llapissos,Guants,Disc de música,Os de peluix
Anna Viu Pallarol: Nina morena,Conillet rosa
Frances Codina Soler: Caramels,Ràdio,Espasa de fusta,Cotxe,Arc i fletxes
Toni Paradís Isanta: Llibre de dibuixos,Escacs,Biberó,Os de peluix,Calendari
Toni Jara Masdevall: Cowboy
Baldiri Mercadé Marcó: Televisor,Joc de taula,Nina rossa
Iu  Maldonado: Televisor,Capsa de bombons,Os de peluix
Gerard March Miravet: Llapissos
Cristian Ortega Pijoan: Llibre,Televisor,Mòbil,Jersei,Nina bebé,Còmic
Cesc Lara Piñol: Rellotge,Llibreta,Sabates,Nina bebé,Gorro,Colònia
Ot Molas Perez: Còmic,Ordinador
Miquel Guvern Marcu: Bufanda,Cadireta
Alfred Lara Pairó: Nina bebé,Mitxons
Marta Masllorens Mínguez: Mòbil
Toni Murga Llach: Conillet rosa,Ràdio
Enric Albí Viu: Torró,Nina rossa,Ràdio
Alfred Monné Montràs: Televisor,Llapissos,Sabons,Mitxons,Galetes
Carles Pericas Huguet: Galetes,Llibreta,Manta,Arc i fletxes
Candela Majós Maluquer: Biberó,Calendari
Filomenu Morillo Llort: Manta,Llibre de dibuixos,Joc de taula,Retallable,Bufanda,Cotxe
Queralt Llort Guardiola: Televisor,Llapissos,Rellotge,Guants
Daniel Mata Moya: Bossa de mà,Disc de música,Ràdio
Pep Jorba Masclans: Cowboy
Jesus Huguet Perez: Jersei
Zeus Majós Maginet: Mòbil,Caramels,Llibreta,Cotxe,Cowboy
David Rodríguez Messegué: Tren
Diego Julià Isern: Llapissos,Colònia,Calendari
Helena Sonet Macià: Televisor,Os de peluix
Homer Brunyol Miravet: Llibre
Cristian Mans Mancho: Mòbil,Llibreta,Jaqueta,Jersei
Cesc Pey Parer: Llibre,Calendari,Nina rossa,Puzzle,Conillet rosa,Llibreta
Manel Mercadé Llorente: Guerrer amb espasa,Ordinador
Frederic Pallarol Ricart: Galetes,Colònia,Conillet rosa,Llibreta,Casa de nines
Zeus Icart Guevara: Rellotge
Jou Marcó Pinot: Nina bebé,Os de peluix,Cowboy
Iu Marsà Alba: Retallable,Mitxons,Mitjons,Espasa de fusta,Sabates,Llibreta
Queralt Oliveras Maluquer: Bufanda,Ulleres de sol,Llibre
Pere Lloris Margalef: Mitjons
Josep Oliva Brau: Gorro,Televisor,Mòbil
Susanna Paraire Oveja: Caramels,Estoig
Daniel Fernàndez Gasull: Disc de música,Ordinador
Gerard Pairó Medrano: Mocador de coll
Jou Marqués Malé: Mocador de coll,Caramels,Ràdio,Cotxe,Bossa de mà
Paco Llansana Malla: Capsa de bombons,Espasa de fusta
Mònica Padrosa Matute: Guerrer amb espasa
Pitu  Montroig: Llibre de dibuixos,Nina morena,Calendari
Helena Molas López: Galetes,Puzzle,Nina morena,Disc de música,Bicicleta
Aina Sabater Llabot: Escacs,Bossa de mà,Caramels,Calendari,Cadireta
Candela Gasull Pericas: Llibre de dibuixos,Escacs,Sabons,Nina rossa
Candela Masachs Moragues: Llibre,Mocador de coll
Josep Llansana Llanet: Llibre,Sabons,Cotxe elèctric,Bicicleta,Calendari,Torró
Maria Pastoret Hernández: Gorro,Mòbil,Llibreta,Arc i fletxes
Marta Juncosa Malé: Mòbil,Joc de taula
Gerard Perez Mallafré: Cotxe,Cowboy
Joan Martell Huguet: Llibre de dibuixos,Escacs,Llibre,Capsa de bombons,Mocador de coll
Carles Palau Petit: Televisor,Cotxe elèctric
Angela Viu Mínguez: Gorro
Sam Llatser Paladell: Galetes,Colònia,Estoig,Bicicleta
Mireia Pia Marlés: Bufanda,Mòbil,Conillet rosa,Llapissos
Maria Maruny Pedrol: Jaqueta,Corbata,Conillet rosa,Calendari,Manta,Ordinador
Maria Lluisa Miravet Pesarrodona: Tren,Llibre de dibuixos,Jersei,Ràdio,Bufanda,Cotxe elèctric
Angela Hernández Petit: Televisor,Rellotge,Manta,Puzzle,Estoig,Ràdio
Pepa Palau Rodríguez: Puzzle,Colònia,Sabons,Espasa de fusta,Biberó
Max Lluch Guixà: Gorro,Joc de taula,Bicicleta
Queralt Lladó Llanet: Retallable,Rellotge,Ordinador,Sabates
Cristian Mitjavila Julià: Bufanda,Llibreta,Casa de nines
Maria Lluisa Marot Negre: Llibre de dibuixos,Sabates,Bicicleta,Nina rossa,Escacs,Os de peluix
Miquel Murga Just: Sabons,Torró
Baldiri Mayné Ricart: Llibre de dibuixos,Nina bebé,Cotxe elèctric,Ordinador,Nina morena
Jean Codina Matute: Gorro,Colònia,Estoig
Gerard Marlés Matamala: Retallable,Guants
Maria Pedreño Pey: Retallable,Televisor,Rellotge,Biberó,Cowboy
Diego Masolivé Llobet: Rellotge,Puzzle,Manta,Caramels
Susanna Pujol Casajuana: Nina morena
Mireia Oveja Gual: Caramels,Cadireta,Disc de música,Bicicleta
Joanot Jaques Pastoret: Biberó
Helena Majós Hom: Nina morena,Llapissos,Colònia,Disc de música,Os de peluix
Lluis Pesarrodona Manyé: Escacs,Gorro,Puzzle,Sabons
Sònia Macià Maluquer: Jaqueta,Mitjons
Carles Jodar Medrano: Jaqueta,Os de peluix
Met Pallarol Orobitg: Galetes,Mòbil,Nina morena,Estoig
Cesc Icart Gasull: Nina bebé
Fe Masclans Alba: Llibre,Ulleres de sol,Biberó,Guants,Cotxe
Frederic Alba Tubau: Casa de nines
Homer Isern Padrosa: Manta,Disc de música
Paco Matute Junyent: Bossa de mà,Mitxons,Guants,Arc i fletxes,Ràdio
Helena Pastoret Petrus: Bufanda,Còmic,Sabates
Queralt Llatser Mercadé: Llibre,Mitxons,Jersei,Tren
Diego Bru Guimerà: Mòbil,Biberó,Sabates
Magda Macrané Matamala: Llibre de dibuixos,Caramels,Torró,Tren
Joan Marata Pujol: Espasa de fusta,Joc de taula
Rufo Pey Jiménez: Corbata,Bicicleta
Candela Solé Medrano: Tren
Queralt Latre Jorquera: Llibre,Manta,Jersei
Filomenu Taberner Pinot: Os de peluix,Televisor,Còmic,Mitjons,Calendari
Pepa Medrano Pelayo: Guants,Sabates,Nina rossa,Cadireta,Colònia,Cotxe
Pep Mascarell Ortega: Torró,Cotxe elèctric
Zeus Llucià Visent: Bufanda,Llibreta,Casa de nines
Joan Lara Mitjavila: Llibre,Televisor,Nina morena,Conillet rosa
Pol Vilamoll Pellicer: Llibreta,Torró,Joc de taula
Angela Masachs Ingla: Caramels,Llibre de dibuixos,Bossa de mà,Mitjons,Galetes,Cotxe elèctric
Susanna Maruny Bru: Biberó,Calendari
Fe Hom Margalef: Còmic,Espasa de fusta,Cotxe
Pol Aubert Manzano: Caramels,Jersei,Tren
Cesc Pi Boix: Os de peluix
Gerard Magrinyà Padilla: Gorro,Manta
Pere Isern Pey: Jaqueta
Mireia Petrus Montràs: Televisor,Conillet rosa,Os de peluix,Ràdio
Josep Antoni Pesarrodona Alemany: Bossa de mà
Joan Pou Matarodona: Mocador de coll,Ordinador,Arc i fletxes
Josep Antoni Mont Pedreño: Bufanda,Caramels,Guerrer amb espasa,Espasa de fusta
Joan Josep Mayans Bru: Mitxons
Bernat Lloris : Bufanda
Bernarda Lladó López: Bufanda,Llibre de dibuixos,Caramels,Llibreta
Josep Jové Vives: Caramels,Jaqueta,Nina rossa,Gorro,Colònia,Os de peluix
Didac Padilla Matute: Llibre,Mocador de coll,Puzzle,Mòbil,Ulleres de sol,Capsa de bombons
Frances Casajuana Mallafré: Llibre de dibuixos,Mòbil,Puzzle,Nina morena,Nina rossa,Bossa de mà
Marta Palomera Morillo: Rellotge,Sabates
Lluis Guvern Jorba: Llapissos,Nina rossa,Casa de nines
Joaquim Llatser Roure: Bossa de mà,Manta,Espasa de fusta
Candela Gasull Masmitjà: Galetes,Bicicleta,Mitxons,Casa de nines,Arc i fletxes
Bernat Marata Bru: Jersei,Conillet rosa,Sabates,Bicicleta
Joaquim Armengol Jordana: Mitxons,Corbata
Alfons Llofriu Majós: Bufanda,Sabons,Cotxe elèctric,Jaqueta,Tren
Diego Malla Marqués: Colònia,Manta
Joan Miravet Visent: Retallable,Puzzle,Rellotge,Joc de taula,Arc i fletxes
Iu Giménez Lladó: Colònia
Maria Tubau Tió: Gorro,Nina bebé,Joc de taula
Jou Llort Marsany: Llibre de dibuixos,Rellotge,Torró,Conillet rosa,Tren
Carles Hom Icart: Televisor,Gorro
Daniel Marqués Pallejà: Caramels,Bossa de mà,Nina bebé,Mòbil,Gorro,Capsa de bombons
Frances Masvidal Maymó: Puzzle,Llibreta,Cadireta
Magda Jornet Marti: Gorro,Bufanda,Sabons,Sabates,Cowboy
Candela Just Pairó: Biberó
Iu Llansana Pedreño: Televisor,Sabons,Calendari,Mitxons,Conillet rosa,Cotxe
Josep Junyent Pericas: Nina bebé,Llibreta,Guants,Bicicleta
Joan Josep Mayné Llansana: Cotxe elèctric,Disc de música,Nina rossa
Marti Guasch Mitjavila: Gorro,Torró,Os de peluix,Ràdio
Maria Lluisa Pinot Isanta: Rellotge
Alfons Pesarrodona Lloris: Torró,Jaqueta,Sabates
Frances Guvern Maurell: Nina bebé,Corbata,Os de peluix
Carles González Moya: Bufanda,Rellotge,Torró
Víctor Iglesias Hom: Llibre de dibuixos
Antonia Maldonado Soler: Sabons,Tren
Bernarda Vives Masachs: Llibre de dibuixos,Llibreta,Joc de taula,Sabates
Jesus Oliva Masdefiol: Galetes,Bicicleta,Estoig,Tren
Manel Padilla Orobitg: Guerrer amb espasa,Mitjons,Gorro,Bufanda,Cotxe elèctric,Disc de música
Magda Navajas Pia: Televisor,Caramels,Manta
Maria Lluisa Raga Manent: Mòbil,Estoig
Pitu Margalef Llorente: Llapissos,Biberó,Corbata,Nina rossa,Galetes,Cotxe elèctric
Xavier Paraire Murga: Capsa de bombons,Jersei,Llibreta,Biberó
David Taberner Alemany: Llapissos,Bicicleta
Iu Platja Negre: Ulleres de sol,Rellotge,Manta,Jersei,Cowboy
Baldiri Molas Oliveras: Escacs,Llapissos,Jersei
Alfred Bonastre Maginet: Còmic,Sabates
Joan Josep Montroig Giménez: Llapissos,Rellotge,Puzzle,Espasa de fusta,Llibreta,Cotxe
Miquel Piferrer Laborda: Televisor,Bossa de mà,Guants,Ràdio,Conillet rosa,Gorro
Joan Matamala Llabot: Televisor,Colònia,Nina rossa,Cotxe elèctric,Ràdio
Paco Vinals Molas: Cotxe
Maria Jorquera Laborda: Còmic
Joan Nogué Moron: Caramels,Casa de nines,Jersei,Ràdio,Espasa de fusta,Llibreta
Enric Montroig Negre: Sabates
Mònica Matamala Marqués: Espasa de fusta
Joan Pont Magrinyà: Capsa de bombons,Nina bebé,Guerrer amb espasa,Jaqueta
Toni Tió Luque: Puzzle
Candela Mayans Mayné: Manta,Mitjons,Nina bebé,Arc i fletxes,Escacs,Ordinador
Joaquim Llabot Marcos: Mòbil,Torró,Calendari,Sabates
Bernarda Junyent Oliveras: Llibre de dibuixos,Llibreta
Pere Monells Marti: Mitxons,Guerrer amb espasa,Joc de taula
Sam Latre Platja: Retallable,Os de peluix,Arc i fletxes
Anna Majós Marti: Llibre,Nina bebé,Guants,Televisor
Òscar Maurell Molas: Cotxe elèctric,Cotxe
Daniel Pastoret Malla: Nina rossa
Didac Negre Mula: Escacs,Televisor,Manta
Paco Cardona Guimerà: Capsa de bombons,Jaqueta,Disc de música,Casa de nines
Max Guimerà Gasull: Nina morena
Met Ortiz Montràs: Bossa de mà,Jersei
Pere Jordana Picanyol: Bufanda
Joan Josep Medina Palop: Nina bebé,Rellotge,Torró,Cotxe,Sabates
Merce Guimerà Fernàndez: Rellotge,Disc de música
Pitu Llauradó Alcoberro: Sabons,Arc i fletxes
Joan Soler Agulla: Llibre de dibuixos,Nina bebé
Joaquim Matarodona Lara: Llibre de dibuixos,Llibreta,Jaqueta,Sabates
Jou Marti Ortiz: Retallable,Corbata
Pere Mercadé Pont: Llibre,Os de peluix,Cowboy
Queralt Ortiz Marqués: Rellotge,Capsa de bombons
Sergi Mula Jorquera: Capsa de bombons,Colònia,Torró,Jaqueta,Sabates
Mireia Giménez Ruiz: Bufanda,Puzzle,Cotxe elèctric,Biberó,Casa de nines
Zeus Mundó Taberner: Jaqueta,Sabates
Pitu Masolivé Oliva: Ulleres de sol,Disc de música,Espasa de fusta,Ràdio
Lluis Mula Guasch: Caramels,Biberó,Puzzle,Guerrer amb espasa,Calendari,Llibreta
Marta Llobet Armengol: Ulleres de sol,Còmic,Guants,Nina morena,Calendari
Joan Josep Lladó Masmitjà: Guants,Corbata
Mireia Masllorens Masolivé: Caramels,Guants,Nina rossa
Joan Josep Llauradó Pericas: Galetes,Bossa de mà
David Mayans Ibarra: Bossa de mà,Disc de música,Ràdio
Zeus Montroig Albiol: Mocador de coll,Mitxons,Còmic,Bossa de mà
Anna Rey Mallafré: Galetes
Pol Marlés Taberner: Capsa de bombons,Espasa de fusta
Pepa Fernàndez Majós: Caramels,Cotxe elèctric,Ordinador,Estoig
Pepa March Llucià: Capsa de bombons,Cadireta,Guants,Ràdio
Aina Llesera Ordeig: Guerrer amb espasa,Tren
Pere Pelegrí Mata: Mocador de coll,Sabates,Os de peluix
Marti Perez Guimerà: Còmic,Manta,Jersei
Frances Ibarra Masachs: Televisor,Llibre,Caramels,Llibreta,Arc i fletxes,Cotxe elèctric
Cristian Palau Masolivé: Ulleres de sol
Jesus Mula Marcó: Corbata,Cowboy,Estoig,Sabates,Cadireta,Colònia
Met Guirao Pey: Retallable,Torró,Mitjons
Quim Laborda Laborda: Escacs,Sabons,Cowboy,Jersei,Arc i fletxes
Aina Majós Munné: Sabons,Biberó,Corbata,Bossa de mà,Mitjons,Espasa de fusta
Baldiri Maldonado Maruny: Cowboy
Sam Mach Tió: Gorro,Llibreta,Estoig,Espasa de fusta,Bicicleta
Ernest Martell Ingla: Cadireta
Angela Mercadé Pitarch: Televisor,Llibre,Manta,Corbata,Jersei,Torró
Joaquim Palau Mula: Escacs
Bernat Gutierrez Ortiz: Manta
Lluis Llofriu Pey: Guerrer amb espasa
Toni Montió Isanta: Nina morena,Biberó
Mònica Llort Mata: Tren
Magda Pia Jorba: Gorro
Pol Marata Alcoberro: Calendari,Jersei,Espasa de fusta
Sònia Paret Latre: Llibreta
Daniel Paret Guevara: Bufanda,Mitxons,Llibreta,Calendari,Cowboy
Gerard Tubau Montroig: Bicicleta
Joan Pericas Parer: Llibre de dibuixos,Sabates
Daniel Marot Maurell: Colònia,Ordinador,Joc de taula,Ràdio
Carles Ruiz Masana: Jaqueta,Casa de nines,Retallable,Espasa de fusta,Jersei,Disc de música
Ot Isanta Ortega: Llibreta,Bicicleta
Marta Mascarell Medina: Bossa de mà,Estoig
Gerard Jordana Jornet: Espasa de fusta,Os de peluix,Arc i fletxes
Pepa Pou Junyent: Televisor,Nina bebé,Caramels,Jaqueta,Nina rossa
Pep Roure Brunyol: Sabons,Jaqueta,Jersei,Espasa de fusta
Magda Ortega Marqués: Mòbil,Cowboy,Còmic,Cotxe elèctric,Ràdio
Joan Josep Pey Marot: Llibreta
Alfred Molas Matarodona: Bossa de mà
Frances Llofriu Laborda: Retallable,Colònia,Mitxons,Ràdio
Josep Antoni Malla Not: Manta,Casa de nines,Guants,Escacs,Jaqueta,Ordinador
Joan Monné Moron: Manta,Corbata,Tren,Estoig,Còmic,Bufanda
Diego Casajuana Padrosa: Llibre,Televisor,Puzzle,Nina morena,Espasa de fusta
Gerard Maldonado Ricart: Llapissos,Manta,Disc de música,Conillet rosa,Mòbil
Sergi Llatser Morral: Llibre,Biberó,Nina morena,Bicicleta,Còmic,Gorro
Daniel Malé Alba: Televisor,Sabons,Guants,Estoig,Espasa de fusta
Daniel Llofriu Taberner: Mitxons,Cotxe elèctric,Biberó
Joanot Matamala Paula: Jaqueta,Manta,Espasa de fusta,Sabates,Bicicleta
Mireia Gasull Alba: Colònia,Nina rossa,Llibre de dibuixos,Sabates,Calendari,Llibreta
Lluis Isanta Iglesias: Bufanda,Colònia,Biberó,Conillet rosa,Arc i fletxes
Frederic Monné Montroig: Llapissos,Còmic,Estoig,Cotxe elèctric
Charly Llobet Llanet: Llibre de dibuixos,Bossa de mà,Sabates,Jersei,Nina rossa,Ulleres de sol
Gerard Guardiola Ingla: Mòbil,Guerrer amb espasa,Guants
Daniel López Jové: Nina morena,Manta,Sabates
Queralt Brau Gutierrez: Ulleres de sol,Còmic,Disc de música,Bicicleta
Alfred Masana Isanta: Llibre,Llapissos,Manta,Puzzle,Calendari,Ordinador
Quim Armengol Pedrol: Mocador de coll,Jersei,Mòbil
Queralt Mata Jiménez: Nina bebé,Torró,Disc de música,Cotxe elèctric
Alfred Pallejà Llofriu: Televisor,Bossa de mà,Rellotge,Guants,Bufanda
Didac Montià Marata: Mocador de coll,Bossa de mà,Bicicleta,Nina rossa,Cowboy
Aina Jaques Jiménez: Sabons,Corbata,Mitxons,Nina morena,Escacs,Disc de música
Pep Páramo Negre: Torró,Guants,Arc i fletxes,Ràdio
Cesc Perez Padrosa: Galetes,Nina bebé,Llibreta
Max Not Marsany: Guants,Arc i fletxes
Sergi Bru March: Puzzle,Jaqueta,Sabons
Carles Macrané Ingla: Nina morena
Max López Lloris: Retallable,Bossa de mà,Sabons,Ràdio
Marti Linares Olivella: Gorro
Merce Montràs Mula: Llapissos,Caramels,Bicicleta,Conillet rosa,Bufanda,Llibreta
Mònica Masclans Moron: Caramels,Capsa de bombons,Manta,Tren
Enric Marlés Aubert: Llibre de dibuixos,Ulleres de sol,Arc i fletxes
Pepa Soler Pey: Caramels,Mitxons,Rellotge,Mitjons
Fe Jorba Maluquer: Mitxons,Llibreta,Disc de música,Os de peluix
Víctor Pelegrí Rey: Gorro,Ulleres de sol,Disc de música,Mitjons
Sergi Monné Aubert: Capsa de bombons
Marti Matarodona Mata: Guerrer amb espasa,Bufanda,Galetes,Ulleres de sol,Llibreta,Disc de música
Sam Paret Albiol: Llibre de dibuixos,Guerrer amb espasa,Jaqueta,Sabates,Biberó
Queralt Magrinyà Marcos: Nina bebé,Disc de música
Cesc Mach Palop: Torró,Puzzle,Capsa de bombons,Mitjons
Pepa Masvidal Petit: Galetes,Jaqueta,Guerrer amb espasa,Còmic,Llibreta
Jean Pinyas Marata: Llibre,Cadireta,Jaqueta,Ràdio
Òscar Tió Jordana: Gorro,Capsa de bombons,Manta,Joc de taula
Josep Oveja Bru: Colònia,Casa de nines,Estoig,Mitjons,Bufanda,Torró
Pol Guevara Llobet: Ordinador,Cadireta
Pol Pijoan Mascarell: Llibre,Puzzle,Colònia,Llibreta,Cadireta
Enric Serra Llansana: Galetes,Escacs,Capsa de bombons
Enric Hom Terrats: Còmic,Manta,Calendari,Cotxe
Didac Messegué Linares: Televisor,Mòbil,Guerrer amb espasa,Calendari,Mocador de coll,Cotxe
Diego Majós Iglesias: Nina bebé,Còmic
Paco Marqués Monells: Llibre,Casa de nines,Estoig,Joc de taula,Gorro,Ordinador
Mireia Maldonado Gasull: Bufanda,Retallable,Cotxe elèctric,Sabates
Anna Petrus Pont: Mitxons,Bicicleta
Pere Llanet Marlés: Bufanda,Ràdio
Víctor Macià López: Galetes,Cotxe,Llibreta,Nina rossa,Jersei
Paco Tubau Malé: Bufanda
Quim Huguet Pi: Gorro
Daniel Tió Masmitjà: Capsa de bombons,Mòbil,Guants,Còmic,Bufanda,Torró
Helena Lluch Marcó: Mitxons
Filomenu Alcoberro Malé: Galetes,Llibreta,Nina rossa,Cadireta
Xavier Mallafré Morral: Jaqueta,Disc de música,Arc i fletxes
Bernat Parer Jornet: Llibreta,Espasa de fusta
Quim Roure Ibarra: Estoig,Sabates
Manel Pia Jové: Mocador de coll,Guants
Iu Soler Gasull: Galetes,Guerrer amb espasa,Disc de música,Cotxe
Candela Isanta Albiol: Llibre,Ulleres de sol,Mitxons,Casa de nines
David Murga Not: Sabons,Manta,Llibre de dibuixos,Mitjons,Espasa de fusta,Torró
Homer Lozano Monné: Sabons
Queralt Llesera González: Os de peluix
Marta Ibarra Morillo: Rellotge,Guants,Joc de taula,Bicicleta,Jersei,Conillet rosa
Diego Llofriu Mascarell: Sabates,Espasa de fusta,Ràdio
Magda Paret Pairó: Galetes,Ulleres de sol,Nina bebé,Casa de nines
Pepa Hom Albí: Cowboy
Alfred Morral Llofriu: Llibre de dibuixos,Capsa de bombons,Ordinador,Calendari,Tren
Quim Masllorens Jorquera: Sabons,Biberó,Ràdio
Ot Luque Solé: Guerrer amb espasa,Manta,Arc i fletxes,Os de peluix,Casa de nines
Josep Pujol Moya: Llibre,Nina bebé,Televisor,Ràdio
Filomenu Hernández Bru: Puzzle,Ràdio,Guerrer amb espasa,Cowboy
Pep Petrus Manyé: Mitxons,Còmic,Calendari
Víctor Palau Mallafré: Ulleres de sol,Guerrer amb espasa
Iu Perez Mata: Llibre de dibuixos,Bicicleta,Corbata,Casa de nines
Cesc Gasull Oliveras: Mitjons,Sabates
Mònica Marín Marcó: Corbata,Cadireta
Carles Oliveras Llofriu: Gorro,Biberó,Nina rossa,Cowboy
Paco Lara Bonastre: Sabons,Sabates,Jersei,Cadireta
Marti Palau Soler: Puzzle,Còmic,Ordinador,Ràdio
Pepa Llatser Pitarch: Mòbil,Corbata,Bossa de mà
Rufo Piqueras Llanet: Mitjons
Enric Marcu Petit: Rellotge,Capsa de bombons,Colònia,Bicicleta
Jou Boix Boix: Mocador de coll,Bicicleta
Ot Boix Iranzo: Ulleres de sol,Llibreta,Espasa de fusta,Disc de música,Sabates
Merce Palau Tubau: Rellotge,Mitjons,Conillet rosa
Anna Ingla Monells: Nina bebé,Puzzle,Conillet rosa,Jersei,Arc i fletxes
Jesus Manzano Oliveras: Cotxe,Calendari,Sabates,Cadireta
Mireia Marti Masachs: Bossa de mà,Guerrer amb espasa
Josep Antoni Nogué Mancho: Caramels
Paco Agulla Marqués: Llibreta,Torró,Joc de taula
Enric Llobet Boix: Mocador de coll,Puzzle,Ordinador,Conillet rosa,Tren
Gerard Piñol Solé: Rellotge,Estoig,Nina bebé,Cadireta,Gorro,Colònia
Met Guevara Malla: Mitxons
Met Vilamoll Matarodona: Llibre,Llapissos,Còmic,Nina bebé
Frederic Maluquer León: Llibre,Gorro,Llibreta,Conillet rosa,Cotxe
Maria Majós Ortega: Rellotge,Còmic,Llibreta
Josep Antoni Brau Pallarol: Llibre de dibuixos,Mocador de coll,Còmic,Galetes,Ulleres de sol,Os de peluix
Mònica Matamala Jara: Bufanda,Estoig,Espasa de fusta
Zeus Maldonado Linares: Llibreta
Pepa Jové Julià: Manta,Bossa de mà,Estoig,Ràdio,Capsa de bombons,Os de peluix
Cristian Masllorens Malé: Bossa de mà,Caramels,Guants,Ordinador,Tren
Enric Palomera Jornet: Rellotge,Nina morena,Jaqueta,Biberó
Marti Ubach Hosta: Sabates,Torró,Corbata,Cotxe
Quim Roure Mata: Galetes,Ulleres de sol,Llibre,Escacs,Nina bebé
Helena Miravet Puig: Gorro,Os de peluix,Calendari,Cowboy
Angela Guevara Puig: Jaqueta,Corbata,Bossa de mà,Nina morena,Mòbil,Os de peluix
Daniel Llorens Mans: Llapissos,Estoig,Mòbil
Enric Pitarch Mercadé: Escacs,Biberó,Nina rossa,Ràdio
Queralt Vinals Montió: Nina morena,Sabates
Merce Vinals Gasull: Biberó,Guerrer amb espasa,Guants,Llibreta,Còmic,Capsa de bombons
Sergi Paraire Llatser: Escacs,Mòbil,Guerrer amb espasa,Nina rossa,Mocador de coll
Queralt Llabot Martell: Gorro,Retallable,Còmic
Cristian Padilla Cardona: Galetes,Llibre,Puzzle,Llibreta,Colònia
Mireia Guevara Pairó: Llibre de dibuixos,Torró,Cowboy
Merce Llanet Orobitg: Cotxe
Carles Pastoret Oliva: Escacs,Joc de taula,Bicicleta
Joan Josep Boix Vives: Bufanda,Capsa de bombons,Mitjons,Cotxe elèctric
Sònia Roure Isern: Caramels,Cotxe elèctric,Jaqueta,Retallable,Calendari,Llibreta
Met Masllorens Gasull: Televisor,Biberó,Conillet rosa,Ràdio
Baldiri Parer : Llapissos,Sabons,Bicicleta,Nina rossa,Mòbil
Susanna Casajuana Matamala: Puzzle,Còmic
Jou Latre Marlés: Llibre de dibuixos
Angela Llabot Agulla: Corbata,Bicicleta
Marta Bonastre Perez: Conillet rosa,Nina morena,Guants,Cotxe,Sabates
Queralt Marín Ruiz: Mòbil,Disc de música,Sabates
Pitu Pou Padrosa: Llibre de dibuixos,Puzzle,Guants,Nina bebé,Nina morena,Nina rossa
Pol Marsany Guvern: Llibre de dibuixos,Ulleres de sol,Guerrer amb espasa
Baldiri Maginet Monells: Mocador de coll,Jersei,Calendari,Cadireta,Llibreta,Ordinador
Helena Masachs Jaques: Capsa de bombons
Pepa Martell Petrus: Disc de música
Sam Boix Mans: Retallable,Llibreta,Còmic,Corbata
Daniel Maldonado Agulla: Mocador de coll
Òscar Palop Codina: Gorro,Colònia,Llibreta,Bicicleta
Cesc Sonet Piñol: Rellotge,Biberó,Cowboy
Cristian Cardona Masclans: Biberó,Televisor,Nina morena,Cotxe elèctric,Cowboy
Mònica Platja Margalef: Bossa de mà,Colònia,Ordinador,Ràdio
Diego Sabater Fernàndez: Galetes
Jou Mata Pelegrí: Retallable,Nina bebé,Escacs,Casa de nines
Magda Guevara Ingla: Capsa de bombons,Bicicleta
Lluis Pi Negre: Galetes,Bossa de mà,Cotxe elèctric,Tren
Frances Gasull Llorente: Caramels,Puzzle,Joc de taula,Galetes,Capsa de bombons,Cotxe
Aina Roure Malla: Cotxe elèctric,Jaqueta
Fe Pedreño Peret: Caramels,Nina morena,Puzzle,Disc de música
Joan Josep Boix Parra: Ràdio,Capsa de bombons,Cowboy
Ernest Petrus Monells: Sabons,Corbata,Sabates,Ràdio,Conillet rosa,Nina rossa
Queralt Messegué Pedrol: Casa de nines,Espasa de fusta,Gorro,Nina morena,Nina rossa,Bufanda
Zeus Parra Raga: Escacs,Llibre de dibuixos,Sabons,Jersei,Cowboy
Marti Masvidal Guixà: Escacs,Retallable,Puzzle,Mitxons
Marta Pesarrodona Piñol: Llibre,Rellotge,Capsa de bombons,Corbata,Sabates
Marti Ubach Roure: Mitxons,Cotxe,Sabates,Cowboy
Zeus Jaques Llorens: Disc de música
Pep Jordana Guasch: Mocador de coll,Tren
Charly Montroig Medina: Llibre,Torró,Estoig,Nina morena,Escacs,Colònia
Queralt Oliva Masvidal: Bossa de mà,Manta,Estoig,Os de peluix
Jesus Lladó Negre: Puzzle
Homer Parra Giménez: Manta,Arc i fletxes
Pere Ricart Albí: Sabons,Mitxons
Filomenu Vilamoll Bonaterra: Sabates
Enric Palau Guasch: Gorro,Cotxe elèctric,Tren
Jean Margalef March: Sabons,Nina rossa,Nina morena,Conillet rosa,Galetes,Capsa de bombons
Alfons Viu Pinyas: Mitxons,Cotxe,Nina rossa
Miquel Masvidal Mancho: Llibre de dibuixos,Còmic,Os de peluix
Maria Marlés Moron: Escacs,Llibreta,Guants,Corbata,Cadireta
Josep Lara Gasull: Escacs,Colònia,Capsa de bombons,Bicicleta
Mònica Giménez Aubert: Còmic,Sabates,Bicicleta
Bernarda Llauradó Julià: Puzzle
Jesus Maurell Iglesias: Sabons,Tren,Llibre de dibuixos,Espasa de fusta,Galetes,Cotxe elèctric
Sònia Lloberes Hosta: Televisor,Estoig,Jersei,Nina bebé,Nina rossa,Os de peluix
Òscar León Mascarell: Llibre,Ràdio,Llibreta,Disc de música,Casa de nines
Pitu Jaques Magrinyà: Televisor,Ulleres de sol,Gorro
Víctor Pujol Masllorens: Retallable,Llapissos,Mitjons,Joc de taula
Marti Guirao Serra: Torró
Anna Masmitjà Martell: Galetes,Cadireta
Jean Tubau Lladó: Nina bebé,Nina morena,Jaqueta,Os de peluix
Diego Munné Pi: Cowboy,Mòbil,Puzzle,Guants,Jersei,Ràdio
Jou Brau Guasch: Llibre de dibuixos,Estoig
Didac Lacalle Luque: Bicicleta,Torró,Cotxe,Casa de nines
Manel Paret Aubert: Llibreta,Cotxe elèctric,Còmic,Espasa de fusta
Toni Llort Magrinyà: Llibreta,Sabates
Joan Julià Masllorens: Llibre,Mòbil,Caramels,Calendari,Cotxe
Charly Paula Isern: Corbata,Llibre de dibuixos,Puzzle,Mitjons,Bicicleta,Disc de música
Queralt Guirao Llach: Llibre,Ulleres de sol,Manta
Charly Llesera Pijoan: Llibre,Puzzle,Colònia,Sabates,Tren
Iu Matarodona Llenas: Cotxe elèctric,Disc de música
Mònica Mallafré Marcos: Mocador de coll,Joc de taula,Galetes,Còmic,Calendari,Gorro
Iu Linares López: Manta,Sabates,Arc i fletxes
Bernarda Peret Lacalle: Televisor,Llibreta,Guants,Ulleres de sol,Torró,Os de peluix
Helena Medrano Lladó: Mitxons
Anna Llach Macrané: Bufanda,Caramels,Còmic,Disc de música
Candela Monné Maruny: Sabates
Lluis Masdevall Juvany: Nina rossa,Llibreta,Calendari,Espasa de fusta,Corbata
Susanna Marsà Negre: Retallable,Gorro,Còmic,Calendari
Iu Pijoan Maymó: Televisor,Jaqueta,Tren,Mòbil,Joc de taula,Nina rossa
Josep Antoni Morral Platja: Mòbil,Disc de música,Corbata
Maria Lluisa Junyent Llatser: Llibre de dibuixos,Puzzle,Biberó
Bernarda Maluquer Mercadal: Rellotge,Puzzle,Disc de música,Escacs,Llibreta,Ordinador
Jean Vinals Pellicer: Nina morena,Corbata,Cotxe,Arc i fletxes
Aina Paraire Matute: Llibre de dibuixos,Televisor,Guerrer amb espasa,Escacs
Josep Antoni Tubau Llort: Puzzle,Torró,Rellotge,Llibreta,Bicicleta
Max Pesarrodona León: Mòbil,Cotxe elèctric,Ulleres de sol,Ràdio
Daniel Petit Bonaterra: Llapissos,Estoig,Llibreta,Disc de música,Ordinador
Baldiri Vilamoll Majós: Televisor,Bossa de mà,Mòbil,Calendari,Bicicleta
Pol Lozano Iglesias: Arc i fletxes,Guants,Llibreta,Bicicleta
Ernest Llach Montià: Ulleres de sol,Cotxe
Joanot Peret Lladó: Caramels,Biberó,Tren,Guants,Mitjons,Cotxe
Enric Hernández Albí: Llibre,Ulleres de sol,Capsa de bombons
Carles Taberner Marcó: Mòbil,Torró
Diego Messegué Piferrer: Torró,Gorro,Puzzle,Capsa de bombons
Alfred Gual Masvidal: Retallable,Guants,Guerrer amb espasa,Còmic,Cowboy
Bernarda Negre Pelayo: Mòbil,Sabons,Calendari,Mocador de coll
Antonia Guvern Monells: Bufanda,Cowboy
Cristian Gutierrez Sabater: Cotxe elèctric,Cowboy
Maria Ordeig Paladell: Llapissos,Puzzle,Bossa de mà
Baldiri Lluch Pallejà: Llibre de dibuixos,Joc de taula
Magda Llach Lloris: Llibre,Mocador de coll,Llibreta,Jaqueta
Susanna Pericas Llucià: Puzzle,Colònia,Sabates,Jersei
Bernarda Juncosa Roure: Cadireta
Magda Bonaterra Monells: Rellotge,Nina bebé,Nina morena,Conillet rosa,Còmic,Disc de música
Bernarda Marlés Guirao: Capsa de bombons
Enric Tió Olivella: Retallable,Mocador de coll,Puzzle,Llibreta
Enric Guardiola Lluch: Escacs,Guerrer amb espasa,Ordinador,Llibreta,Mitjons
Maria Lluisa Moragues Mínguez: Bufanda
Pere Monells Masdevall: Calendari,Mitjons,Sabates
Met Pedreño Jové: Llibre,Gorro,Disc de música,Cadireta
Frederic Mula Soler: Llibre,Rellotge,Jaqueta,Cowboy,Bicicleta,Nina bebé
Frances Rey Giménez: Os de peluix,Còmic,Estoig,Nina rossa,Mitjons
Queralt Morillo Jornet: Cadireta,Colònia,Guants,Bicicleta
Joaquim Padilla Monné: Mocador de coll,Sabates,Cowboy
Pep Molas Platja: Cotxe elèctric,Guants,Conillet rosa,Casa de nines
Frederic Masdevall Margalef: Rellotge,Cowboy,Retallable,Galetes,Escacs,Llibreta
Maria Lluisa Pia Ibarra: Ulleres de sol,Puzzle,Calendari,Sabates,Casa de nines
Joan Josep Jiménez Jodar: Escacs,Mocador de coll,Disc de música,Arc i fletxes
Alfred Pelayo Piñol: Mocador de coll,Mitxons,Sabates
Sam Hernández Marcó: Sabates,Tren
Joan Josep Morillo Pelegrí: Tren,Mòbil,Mitxons,Mitjons,Sabates,Cotxe elèctric
Cesc Julià Junyent: Conillet rosa,Cotxe,Caramels,Sabates,Os de peluix
Maria Lloris Alba: Retallable,Guerrer amb espasa,Nina morena
Didac Vilamoll Masolivé: Bossa de mà,Llibreta,Mitjons,Joc de taula,Disc de música
Rufo Bonastre Not: Escacs,Cotxe,Conillet rosa,Os de peluix,Casa de nines
Candela Pericas León: Caramels,Guerrer amb espasa,Manta,Mitxons,Nina morena,Cotxe
Aina Marsany Mata: Gorro,Rellotge,Torró,Jaqueta,Espasa de fusta
Pere Padrosa Llach: Galetes,Escacs,Nina morena,Tren,Bicicleta
Enric Pericas Latre: Sabons,Estoig
Pep Llabot Pijoan: Bossa de mà,Manta,Llapissos,Sabates,Tren
Josep Antoni Solé Pijoan: Sabons
Joaquim Masachs Hernández: Cowboy
Anna Marcu Serra: Sabons,Biberó,Guerrer amb espasa,Nina bebé,Calendari,Gorro
Joan Masana Paradís: Gorro,Bossa de mà,Rellotge,Manta,Disc de música
Bernat Padrosa Marcó: Llibre de dibuixos,Televisor,Rellotge
Carles Masachs Lara: Galetes,Biberó,Estoig
Magda Piferrer Codina: Colònia,Tren
Marti Not Brau: Guerrer amb espasa,Cadireta
Jesus Pont Jornet: Caramels,Jaqueta,Puzzle,Bicicleta
Queralt Agulla Malla: Caramels,Jaqueta,Corbata,Cotxe
Susanna  Monells: Colònia
Angela Guardiola Albiol: Gorro,Ulleres de sol,Escacs,Corbata,Mocador de coll
Fe Guirao Albí: Retallable,Caramels,Guerrer amb espasa,Os de peluix,Nina rossa
Homer Ortega Ibarra: Colònia,Mitjons,Conillet rosa,Disc de música
Magda Manyé Piñol: Televisor,Joc de taula,Llibreta,Corbata,Nina morena
Queralt Laborda Maurell: Torró,Nina rossa,Biberó
Joan Josep Maymó Margalef: Ràdio,Ulleres de sol,Guerrer amb espasa,Mocador de coll
Helena Juvany Llansana: Sabons,Jersei,Ràdio,Ulleres de sol,Llibreta,Os de peluix
Gerard Lloberes López: Os de peluix
Max Viu Jodar: Llibre de dibuixos,Còmic,Guants,Cotxe,Cowboy
Xavier Messegué Mayné: Rellotge,Espasa de fusta,Mitjons,Nina rossa,Ràdio
Diego Icart Alemany: Capsa de bombons,Caramels,Torró
Antonia Llansana Gasull: Mitjons
Max Vinals Llatser: Sabons,Llibreta,Manta,Conillet rosa
Marta Marcu Parra: Cotxe elèctric,Llibreta,Nina rossa,Cotxe,Tren
Queralt Puig Llatser: Bufanda,Bossa de mà,Sabons,Disc de música,Ordinador
Marta Tubau Ortega: Caramels,Capsa de bombons,Mitjons,Cowboy,Ràdio
Susanna Ingla Llofriu: Rellotge,Manta,Cowboy,Gorro,Ulleres de sol,Torró
Met Jodar Boix: Puzzle,Disc de música,Cotxe
Mireia Marti Orobitg: Televisor
Jean Brau Isanta: Guerrer amb espasa
Maria López Pastoret: Torró,Bicicleta
Zeus Pitarch Luque: Rellotge,Llibreta,Casa de nines,Jersei,Còmic,Capsa de bombons
Jesus Olivella Monells: Guerrer amb espasa
Charly Marcó Masachs: Galetes,Tren,Manta,Joc de taula,Arc i fletxes
Candela Marata Bonaterra: Escacs,Biberó,Jaqueta
Frederic Matute Pallarol: Retallable,Estoig
Pepa Parer Pairó: Llibreta,Caramels,Cotxe elèctric,Disc de música,Sabates
Magda Miravet López: Llibre,Sabons
Felicitat Monné Lladó: Mocador de coll,Cotxe elèctric,Jaqueta
Daniel Guardiola Llorente: Nina bebé
Joaquim Maldonado Jornet: Cadireta
Ot Masllorens Margalef: Televisor,Nina morena
Miquel Visent Pericas: Manta
Angela Margalef Murga: Llapissos,Arc i fletxes
Xavier Pelegrí Isanta: Televisor
Maria Lluisa Pou Pesarrodona: Televisor,Llibreta,Manta
Diego Masachs Ricart: Gorro
Miquel Lacalle Soler: Bufanda,Llapissos,Caramels,Os de peluix,Mocador de coll
Magda Gasull Ricart: Escacs,Llibreta
Enric Palacios Palomera: Guerrer amb espasa,Jersei
Queralt Paret Paradís: Llibre de dibuixos,Mitxons
Paco Hosta Mayné: Nina morena,Llibreta,Ràdio
Mireia Alemany Palau: Llibre,Retallable,Guerrer amb espasa,Capsa de bombons
Antonia Montràs Moron: Bufanda,Nina morena,Jaqueta,Biberó
Zeus Macrané Lluch: Sabons,Llibreta
Rufo Mancho Llesera: Biberó,Ordinador,Arc i fletxes
Jean Linares Ibarra: Manta,Puzzle,Jaqueta
Manel Armengol Pericas: Bossa de mà,Puzzle,Estoig,Sabates
Òscar Mallafré Navajas: Televisor
Gerard Macià Masvidal: Manta,Escacs,Ulleres de sol,Capsa de bombons,Disc de música,Cotxe
Felicitat Jové Perez: Calendari,Estoig,Nina rossa,Cowboy
David Masachs Marín: Llibre,Llibreta,Sabates
Helena Oliva Navajas: Llibre,Torró,Llibreta
Carles Aubert Mula: Bossa de mà,Llibreta,Conillet rosa,Cadireta
Joaquim Iranzo Maluquer: Retallable,Joc de taula
Joan Llesera Oveja: Ulleres de sol
Iu Macrané Marsà: Jersei
Aina Bonaterra Manzano: Manta,Sabates,Mocador de coll,Guants,Joc de taula,Jersei
Magda Malla Manyé: Biberó,Conillet rosa,Os de peluix,Mitjons
Merce Masmitjà Aubert: Rellotge,Cotxe elèctric,Joc de taula
Toni Palacios Ricart: Bossa de mà,Manta
Paco Mínguez Alba: Llibre,Ulleres de sol,Colònia,Manta,Corbata
Quim Pericas Palau: Televisor,Llibre,Torró,Sabates,Os de peluix
Alfons Matamala Mayans: Colònia
Candela Vinals Llach: Nina bebé,Guerrer amb espasa,Os de peluix
Òscar Iranzo Just: Tren,Estoig,Nina morena,Conillet rosa,Cotxe elèctric,Disc de música
Pep Pellicer Pastoret: Mocador de coll,Rellotge,Estoig,Nina rossa,Cadireta
Frances Jové Morillo: Galetes,Calendari
Angela Agulla Mont: Mitjons,Os de peluix,Casa de nines
Pere Marcó Masdefiol: Gorro,Bossa de mà,Llibreta,Corbata
Sam Tubau Marcó: Televisor,Calendari,Conillet rosa,Sabates,Arc i fletxes
Bernarda Alcoberro Leal: Mocador de coll,Cadireta,Guants,Bicicleta
Filomenu Pelegrí Linares: Os de peluix,Calendari,Ordinador
Didac Maurell Pont: Mitxons
Zeus Lloberes Terrats: Mòbil
Cristian Mercadé Matarodona: Os de peluix,Sabons,Colònia,Conillet rosa,Sabates
Quim Rodríguez Paradís: Bufanda,Jaqueta,Ordinador,Corbata
Jean Lladó Peret: Còmic,Sabates,Jersei,Ràdio
Magda Isern Huguet: Mocador de coll,Rellotge,Colònia,Manta,Tren
Angela Petrus Lloris: Sabons,Colònia,Cadireta
Pepa Roure Oveja: Televisor,Estoig
Magda Hom Guimerà: Còmic
Jean Munné Pascal: Gorro,Bufanda,Còmic,Bicicleta
Queralt Lladó Pellicer: Puzzle
Paco Juanola Perez: Os de peluix
Aina Parer Isern: Llapissos,Capsa de bombons,Disc de música,Llibreta
Charly Juncosa Masclans: Sabons
Ernest Marata Piñol: Galetes,Torró,Estoig,Conillet rosa,Cowboy
Manel Llach Mula: Ràdio
Jean Bru Not: Caramels,Llibreta,Sabates,Cowboy
Sònia Iranzo Iranzo: Galetes,Escacs,Llibreta,Ulleres de sol,Bicicleta
Ot Nogué Mata: Televisor,Guants,Os de peluix
David Pou Albiol: Escacs,Capsa de bombons,Llibreta,Calendari,Bicicleta
Homer Montió Pinot: Llibre,Llapissos
Candela Monné Pelayo: Llapissos,Jaqueta,Estoig,Nina bebé,Escacs,Capsa de bombons
Joan Llenas Pinot: Biberó,Calendari,Estoig,Conillet rosa,Disc de música,Os de peluix
Antonia Alba Isanta: Retallable,Guerrer amb espasa,Bicicleta
Susanna Pedrol Juncosa: Llibreta,Ulleres de sol,Colònia,Guants,Joc de taula
Quim Mans Serra: Cotxe elèctric
Quim Guilella Iglesias: Joc de taula
Lluis Marata Albí: Corbata,Sabates
Pitu Ortega Masdefiol: Bossa de mà,Jersei,Os de peluix,Tren
Charly Matarodona Negre: Rellotge,Retallable,Mitjons,Joc de taula,Arc i fletxes,Os de peluix
Jesus Piferrer Huguet: Retallable,Nina bebé,Arc i fletxes,Llibre de dibuixos,Cowboy
Josep Agulla Malé: Mocador de coll,Ulleres de sol,Colònia,Tren
Daniel Pedreño Macrané: Llibreta,Jaqueta,Sabates,Calendari
Zeus Pijoan Oliveras: Colònia
Òscar Bonastre Guevara: Casa de nines
Manel Lladó Juvany: Bufanda,Mòbil,Puzzle,Llibreta,Ordinador
Filomenu Rey Mont: Galetes,Mocador de coll,Llibre,Cadireta
Sam Mach Mancho: Escacs,Mòbil
Lluis Alcoberro Sabater: Llibre de dibuixos,Rellotge,Guants
Josep Visent Ortega: Llibre,Mocador de coll,Llibreta,Manta
Felicitat Jara Jara: Rellotge,Mitxons,Puzzle
Jou Llansana Mercadal: Bossa de mà,Còmic
Ot Lladó Maginet: Conillet rosa
Cesc Orobitg Mata: Llibreta,Guerrer amb espasa,Sabates,Biberó,Nina rossa,Torró
Alfred Platja Piferrer: Biberó,Jaqueta,Estoig,Jersei,Ràdio
Marta Icart Llucià: Bufanda,Nina morena,Còmic,Arc i fletxes
Òscar Medrano Picanyol: Bossa de mà,Nina rossa
Ernest Pedrol Guasch: Rellotge,Bossa de mà,Guants,Espasa de fusta,Bicicleta,Conillet rosa
Susanna Medrano Pascal: Tren,Llibreta,Mitjons,Jersei,Cowboy
Pep Pitarch González: Guerrer amb espasa,Torró,Puzzle,Bicicleta
Frederic Hernández Pitarch: Televisor,Manta,Tren,Llibre de dibuixos,Còmic,Arc i fletxes
Quim Bru Llauradó: Televisor,Bossa de mà,Sabons,Còmic,Joc de taula
Paco Mach Margalef: Ràdio
Manel Pairó Vinals: Bufanda,Nina morena,Casa de nines
Pol Martell Sonet: Llibreta
Pepa Llort Nogué: Jersei,Cowboy
Frances Llesera Luque: Galetes,Bossa de mà,Mitjons,Jersei,Ulleres de sol
Miquel Pinot Mitjavila: Bossa de mà,Cowboy
Angela Pont Jové: Sabons,Manta,Mitjons
Alfons Montià Malla: Escacs,Espasa de fusta,Cowboy
Mireia Marcos Roure: Joc de taula,Cadireta
Daniel González Peret: Cadireta,Casa de nines
Xavier Pou Lloberes: Colònia,Ordinador
Gerard Fernàndez Mont: Sabons,Jaqueta,Sabates,Cowboy
Merce Vives Maldonado: Retallable,Colònia
David Masclans Alemany: Llibre,Llibreta
Pere Ortiz Sabater: Rellotge,Sabates
Jesus Juncosa Matarodona: Retallable,Llapissos,Puzzle,Disc de música,Cowboy
Daniel Marsà Palomera: Colònia,Corbata,Puzzle,Bicicleta,Nina rossa,Llibreta
Pere Llobet Majós: Cadireta
Queralt Masachs Tió: Caramels,Cowboy,Torró,Ordinador,Mitjons
Josep Llorens Pont: Espasa de fusta
Felicitat Paradís Fernàndez: Bufanda,Capsa de bombons,Estoig,Jersei
Zeus Marqués Leal: Galetes,Bufanda
Diego Paradís Albí: Retallable,Puzzle,Rellotge,Estoig
Pepa Viu Just: Calendari
Josep Paret Llanet: Os de peluix,Cotxe
Frances Masachs Lluch: Llibre,Nina morena,Casa de nines
Magda Páramo Isanta: Caramels,Corbata,Mòbil,Espasa de fusta,Nina morena,Calendari
Felicitat Parer Guasch: Colònia,Còmic,Disc de música
Anna Magrinyà Paula: Televisor,Caramels,Llibreta
Alfons Mula Jara: Llibre de dibuixos,Guerrer amb espasa,Sabates,Jersei
Met Manyé Guimerà: Ulleres de sol,Arc i fletxes,Os de peluix,Cotxe,Mocador de coll
Víctor Leal Rodríguez: Rellotge
Cesc Jaques Macià: Bufanda,Torró,Cowboy
Joanot Ubach Llatser: Retallable,Bufanda
Gerard Gasull Llauradó: Caramels,Os de peluix,Tren
Sergi Gasull Guixà: Gorro,Arc i fletxes
Enric Cardona Paraire: Colònia
Alfons Molas Nogué: Biberó,Guants,Nina morena,Ulleres de sol,Capsa de bombons,Cotxe
Quim Jordana Peret: Sabons,Guerrer amb espasa,Jaqueta,Puzzle,Tren
Pere Roure Palomera: Rellotge,Llibreta,Nina rossa,Bicicleta
Joanot Marsany Maluquer: Bufanda,Mocador de coll,Escacs,Conillet rosa,Tren
Toni Ordeig Palau: Bufanda,Mocador de coll,Espasa de fusta,Calendari
Marti Guirao Llanet: Retallable,Nina rossa
Bernat Palau Peret: Disc de música,Corbata,Mitjons,Arc i fletxes
Paco Llanet Llatser: Televisor,Puzzle,Mitxons,Jaqueta,Sabates
Iu Marsany Pellicer: Televisor,Rellotge,Llibreta,Còmic,Estoig
Filomenu Albí Piferrer: Mitxons
Helena Mínguez Alcoberro: Manta
Josep Antoni Marcet Lacalle: Bossa de mà,Rellotge,Llibreta,Còmic,Bicicleta
Filomenu Codina Ubach: Cotxe elèctric
Manel Paladell Pairó: Televisor,Llibre,Bossa de mà,Puzzle,Gorro,Capsa de bombons
Zeus Oliva Masllorens: Casa de nines,Guerrer amb espasa,Bicicleta,Còmic,Ulleres de sol,Llibreta
Candela Mancho Miravet: Puzzle,Jersei,Arc i fletxes,Bufanda,Llibreta,Disc de música
Maria Lluisa Moron Munné: Mocador de coll
Joanot Leal Maruny: Mitxons,Nina rossa,Espasa de fusta
Alfred Palau Pujol: Bufanda,Mòbil,Calendari,Os de peluix,Sabates
Magda Pedreño Boix: Llapissos,Jaqueta,Retallable,Bossa de mà,Estoig,Nina morena
Sam Palop Nogué: Gorro,Nina morena,Estoig,Jersei
Carles Viu Llabot: Llapissos,Ràdio,Corbata,Disc de música
Pitu Palomera Parra: Mitxons
Susanna Mancho Piñol: Escacs,Llibre de dibuixos,Colònia,Corbata
Paco Paula Morillo: Llapissos,Biberó,Sabates,Torró,Disc de música,Cotxe
Marta Pallarol Taberner: Guerrer amb espasa
Maria Lluisa Mercadé Juvany: Rellotge,Cowboy,Jersei,Nina bebé,Disc de música,Os de peluix
Xavier Pallejà Messegué: Escacs,Caramels
Candela Pallejà Miravet: Retallable,Cotxe elèctric,Corbata,Joc de taula
Pepa Agulla Majós: Escacs,Mòbil,Casa de nines
Helena Masana Murga: Llibreta,Calendari,Cowboy
Jou Iglesias Roure: Llibre,Caramels,Corbata,Mocador de coll,Ulleres de sol,Capsa de bombons
Bernat Pitarch Pinot: Bossa de mà,Sabons,Estoig
Marta Llofriu Masvidal: Escacs,Caramels,Ordinador,Cotxe
Aina Alcoberro Visent: Colònia
Antonia Vinals Piqueras: Manta
Joan Llansana Llorens: Nina bebé,Guerrer amb espasa,Colònia,Sabons,Cotxe
Joaquim Marcet Jové: Ordinador,Casa de nines
Lluis Lluch Just: Retallable
Candela Jorba Boix: Llibre,Caramels,Tren,Casa de nines,Mitjons,Llibreta
Aina Tió Ubach: Mitxons,Arc i fletxes
Quim Pellicer Moya: Retallable,Mòbil,Bicicleta,Conillet rosa,Tren
Josep Mayans Paraire: Nina morena,Còmic,Estoig,Cotxe,Casa de nines
Xavier Pelegrí Lloberes: Televisor,Caramels,Colònia,Bicicleta
Aina Boix Montràs: Capsa de bombons
Joanot Piñol Hernández: Puzzle
Víctor Llofriu Marcos: Televisor,Sabates
Aina Moron Martell: Llibre,Ulleres de sol,Rellotge,Corbata
Aina Pellicer Llach: Retallable,Galetes,Mitjons,Sabates,Ràdio
Merce Visent Isern: Sabons,Mitxons,Ràdio
Òscar Montià Padilla: Televisor,Biberó,Cotxe,Sabates,Cadireta
Magda Llanet Mula: Guants,Calendari,Os de peluix
Anna Ubach Jara: Bufanda,Torró,Manta,Os de peluix
Jesus Terrats Maruny: Cadireta
Baldiri Marcó Isanta: Torró,Mocador de coll,Mitxons,Gorro,Bicicleta
Josep Antoni Morral Ubach: Gorro,Cadireta,Espasa de fusta,Arc i fletxes
Josep Antoni Lloris Gasull: Llibre de dibuixos,Cotxe elèctric
Alfons Maldonado Pia: Llibre,Corbata
Met Ricart Juncosa: Joc de taula
Magda Montroig Masdefiol: Llibre,Puzzle
Mireia Majós Masachs: Ulleres de sol,Colònia,Jaqueta
Susanna Mula Marlés: Escacs,Ulleres de sol,Estoig
Cristian Ruiz Raga: Cotxe elèctric,Mòbil,Guants,Sabates,Gorro,Capsa de bombons
Paco Negre Llenas: Rellotge,Cotxe
Anna Matarodona Moya: Llapissos,Cotxe elèctric,Espasa de fusta,Mòbil
Mireia Luque Macià: Torró,Espasa de fusta
Jou Jiménez Miravet: Rellotge
Angela Junyent Juanola: Puzzle,Torró
Josep Antoni Llorente Alcoberro: Biberó,Mocador de coll,Arc i fletxes,Llibreta,Cadireta,Capsa de bombons
Gerard Pastoret Matarodona: Sabates
Angela Not Messegué: Guants,Espasa de fusta,Conillet rosa,Cowboy
Marta Malla Manent: Escacs,Retallable,Colònia
Diego Mancho Marín: Televisor,Bufanda,Puzzle,Cotxe elèctric,Tren
David Mont Mont: Bossa de mà,Ordinador
Joaquim Messegué Parra: Cotxe elèctric,Os de peluix,Casa de nines
Ernest Bru Agulla: Manta,Estoig
Sam Marqués Leal: Bossa de mà
Sam Pastoret March: Caramels,Corbata,Rellotge,Galetes,Nina rossa,Bufanda
Ernest Pia Macrané: Televisor,Llibre,Colònia,Joc de taula,Gorro
Max Palacios Masdevall: Galetes,Mòbil,Cotxe elèctric,Cowboy
Sam Morillo Jorba: Torró,Guants
Angela Mayné Macrané: Sabates,Disc de música,Nina rossa,Mitjons
Pol Marqués Paladell: Capsa de bombons,Joc de taula
Homer Oveja Visent: Ulleres de sol,Torró,Espasa de fusta,Cotxe,Bicicleta
Xavier Viu Jara: Retallable,Llibre,Mitjons
Baldiri Piqueras Mercadé: Nina morena,Espasa de fusta
Felicitat Pedreño Masdevall: Sabons,Manta,Caramels
Frances Guvern Marqués: Manta,Casa de nines,Mòbil,Calendari,Gorro,Colònia
Pepa Petrus Ubach: Rellotge,Guants,Galetes,Còmic,Gorro,Os de peluix
Xavier Jara Masclans: Llapissos,Manta,Mitjons,Bicicleta
Zeus Miravet Gasull: Mòbil,Còmic,Llapissos
Toni Palau Mascarell: Llapissos,Mitxons,Estoig,Sabates,Ràdio
Pitu Lluch Mula: Bossa de mà,Espasa de fusta,Còmic,Mocador de coll,Llibreta,Ordinador
Magda Pont Murga: Televisor,Os de peluix,Joc de taula
Xavier Llauradó Pairó: Televisor,Cotxe elèctric,Jaqueta,Estoig,Ordinador
Joanot Paula Iglesias: Galetes,Retallable,Disc de música
Aina Pelegrí Pallejà: Sabons,Guants,Sabates,Joc de taula
Frances Vinals Marcos: Sabons,Tren,Cowboy,Bicicleta
Víctor Pinot Junyent: Guerrer amb espasa,Calendari
Cristian Majós Oliveras: Llibreta,Gorro,Cotxe elèctric,Jersei
Bernarda Gual Bonaterra: Llibre,Arc i fletxes
Anna Agulla Llorente: Llibre de dibuixos,Mocador de coll,Llibreta,Tren,Nina bebé
Alfred Parra Ingla: Bossa de mà,Sabons,Llibreta
Pol Marti Macrané: Bossa de mà,Ràdio,Mitjons,Mocador de coll
Daniel Pey Manzano: Retallable,Cotxe elèctric,Manta
Alfons Mínguez Manzano: Retallable,Bufanda,Sabons,Colònia,Corbata
Helena Codina Monné: Mocador de coll,Còmic
Antonia Pujol Maymó: Colònia,Jersei
Rufo Albí Codina: Mòbil,Llibreta,Manta
Òscar Pellicer Mans: Caramels,Còmic,Sabates
Sam Margalef Piqueras: Mocador de coll
Susanna Martell Maurell: Llibre,Joc de taula,Cowboy
Met González Viu: Bufanda,Mocador de coll,Cotxe elèctric,Guants,Llibreta
Frances Not Pericas: Televisor,Nina morena,Manta,Estoig,Bicicleta
Alfons Guardiola Pi: Guants,Sabates
Manel Paret Lacalle: Biberó,Jaqueta,Nina rossa
Filomenu Parer Marsany: Colònia
Zeus Pairó Navajas: Llibreta,Cadireta
Pol Molas Pitarch: Televisor,Llibreta,Arc i fletxes
Queralt Parer Paret: Mòbil,Disc de música,Conillet rosa,Mocador de coll
Zeus Pou Llort: Guerrer amb espasa,Biberó,Guants,Ordinador,Ràdio
Candela Maruny Pedrol: Puzzle,Joc de taula,Calendari,Disc de música
Antonia Guasch Maluquer: Mitxons
Toni Mascarell Gutierrez: Llibre,Sabates,Calendari
Candela Taberner Morral: Sabons,Nina morena,Arc i fletxes
Antonia Ingla Soler: Galetes,Os de peluix
Zeus Matamala Gasull: Retallable,Nina bebé,Cadireta
Ernest Padrosa Pia: Biberó,Conillet rosa,Cowboy,Guerrer amb espasa,Nina rossa,Cotxe elèctric
Diego Pujol Palop: Colònia,Jaqueta
Pol Isern Masachs: Jaqueta
Anna Marot Junyent: Jersei,Cotxe
Rufo Marcet Paula: Mitjons,Bicicleta,Conillet rosa,Cadireta,Bufanda,Torró
Helena Moya Luque: Llapissos,Rellotge,Cotxe elèctric,Jaqueta,Caramels,Capsa de bombons
Alfred Linares Albí: Sabons,Mitxons,Galetes,Calendari,Escacs,Os de peluix
Filomenu Vinals Alcoberro: Llibreta,Ràdio
Joaquim Páramo Montràs: Biberó,Conillet rosa,Cotxe elèctric
Joan Paret Guimerà: Llibreta,Arc i fletxes
Quim Orobitg Montió: Ordinador
Joanot Bonastre Monells: Mitjons,Conillet rosa
Lluis Jordana Montió: Televisor,Arc i fletxes
Maria Lluisa Pascal Mercadé: Mitjons,Joc de taula
Jesus Guasch Serra: Gorro,Ulleres de sol,Rellotge,Guerrer amb espasa,Ràdio
Pol Bonastre Masclans: Llibre
Homer Piñol Parra: Ulleres de sol,Os de peluix,Cotxe,Nina bebé
Helena Marata Mata: Llibre,Sabates
Jean Sabater Pia: Bicicleta,Nina morena,Còmic,Sabates,Ràdio
Maria Lluisa Masachs Mancho: Galetes,Nina rossa,Arc i fletxes
Carles Pesarrodona Albí: Disc de música
Alfons Maldonado Montroig: Cowboy,Guerrer amb espasa,Escacs,Bufanda,Galetes,Ordinador
Sergi Guimerà Palop: Gorro,Mocador de coll,Os de peluix,Sabates,Bossa de mà
Sònia Mallafré Guilella: Mòbil,Cotxe
Ernest Orobitg Mach: Biberó,Ràdio,Capsa de bombons,Nina rossa,Escacs,Colònia
Homer Petrus Leal: Gorro,Capsa de bombons,Llibreta,Sabates
Òscar Monells Morral: Caramels,Colònia,Guants,Corbata
Felicitat Masmitjà Mayans: Escacs,Ulleres de sol,Rellotge,Còmic,Cadireta
Joan Malla Páramo: Colònia,Ordinador,Os de peluix
Filomenu Marata Olivella: Capsa de bombons
Mireia Llofriu Manyé: Puzzle
Sònia Monné Juncosa: Escacs,Capsa de bombons,Tren,Casa de nines
Antonia Vives Magrinyà: Caramels,Guerrer amb espasa,Mitjons,Ràdio,Nina bebé,Arc i fletxes
Joaquim Albí Maldonado: Nina morena,Sabons,Colònia,Rellotge
Alfred Visent Mascarell: Colònia,Puzzle,Nina rossa,Bufanda,Llibreta,Cotxe
Susanna Juncosa Miravet: Televisor,Estoig
Ernest Palop Llach: Disc de música,Mocador de coll,Corbata,Os de peluix,Cadireta
Didac Macrané Mans: Televisor,Llapissos,Tren,Puzzle,Bufanda,Cotxe
Zeus Parer Mitjavila: Llapissos,Ràdio
Bernarda Fernàndez Parer: Bufanda,Mòbil,Biberó,Llibre de dibuixos,Bicicleta
Pere Juncosa Pericas: Torró,Nina morena,Os de peluix,Casa de nines
Cesc Pesarrodona Mayné: Tren
Daniel Mans Codina: Retallable,Llapissos,Bossa de mà,Conillet rosa,Tren
Joanot Paradís Guardiola: Llibre
Diego Llauradó Macià: Mocador de coll,Calendari
Frances Palomera Moya: Galetes,Llapissos,Espasa de fusta,Bicicleta
Cristian Lladó Taberner: Sabates,Puzzle,Disc de música,Espasa de fusta,Casa de nines
Fe Viu Montià: Sabons,Torró,Ordinador,Os de peluix
Maria Mínguez Parra: Caramels,Tren,Guants,Joc de taula,Galetes,Torró
Frederic Marata Morillo: Arc i fletxes
Joan Mayans Pedreño: Llibreta,Ulleres de sol,Torró,Conillet rosa,Sabates
Miquel Maruny Huguet: Torró,Rellotge,Llibreta,Tren
Antonia Guixà Llansana: Llibreta,Disc de música,Casa de nines
Maria Llorente Hernández: Puzzle,Sabates,Ràdio
Mireia Marcu Jorquera: Nina bebé,Guerrer amb espasa,Cotxe,Ràdio
Josep Antoni Maginet Guimerà: Cadireta,Cotxe elèctric,Nina rossa,Arc i fletxes
Felicitat Junyent Jornet: Sabons,Guants,Nina rossa,Cowboy
Charly Maruny Juvany: Escacs,Jersei
Rufo Pelayo Vinals: Jaqueta
Zeus Jorquera Llucià: Llapissos,Sabons,Nina morena,Joc de taula
Candela Iranzo Puig: Llibreta,Manta,Nina rossa,Espasa de fusta,Cadireta
Susanna Masdevall Vilamoll: Guants
Manel Oliveras Marcu: Còmic
Charly Ricart Hom: Televisor,Galetes
Cristian Sabater Morillo: Mocador de coll,Ulleres de sol,Cadireta
Maria Gasull Mascarell: Llapissos,Cowboy
Mònica Marín Giménez: Puzzle,Llibreta,Manta,Jersei
Joanot Marata March: Puzzle,Guants,Joc de taula,Ràdio,Gorro,Ulleres de sol
Xavier Llucià Albí: Llapissos,Llibre de dibuixos,Guants,Retallable,Escacs,Cotxe elèctric
Maria Agulla Murga: Gorro,Rellotge,Colònia,Cotxe elèctric,Nina rossa
Queralt Maymó Soler: Cowboy,Capsa de bombons,Nina morena,Joc de taula,Ràdio
Carles Junyent Pallarol: Llibre,Retallable,Bossa de mà,Guants,Bufanda,Torró
Miquel Icart Not: Calendari,Cowboy
Didac Llenas Linares: Gorro
Manel Miravet Rey: Capsa de bombons,Llapissos,Guerrer amb espasa
Diego Negre Ordeig: Casa de nines
Marti Alcoberro Lluch: Puzzle
Alfred Gual Palop: Retallable,Arc i fletxes
Mònica Linares Maymó: Bufanda,Llapissos,Tren,Cotxe,Bossa de mà
Filomenu Ruiz Juvany: Cadireta
Queralt Masana Sabater: Bossa de mà,Joc de taula,Disc de música,Os de peluix,Cowboy
Bernarda Montià Palomera: Corbata,Joc de taula
Rufo Maurell Guardiola: Guants,Sabates
Pepa Messegué Isern: Estoig,Ordinador
Jesus Moron Jorba: Bufanda,Rellotge,Manta
Sam Mancho Jodar: Guerrer amb espasa,Disc de música
Alfred Guixà Maldonado: Gorro,Puzzle,Guerrer amb espasa
Ot Jornet Moragues: Puzzle,Sabates
Josep Agulla Palau: Televisor,Rellotge,Tren,Llibre de dibuixos,Guerrer amb espasa,Llibreta
Manel Guardiola Bru: Biberó,Ordinador,Conillet rosa
Mireia López Maurell: Biberó,Tren
Cesc Iranzo Montràs: Llibre
Alfred Maluquer Sabater: Gorro,Mocador de coll,Colònia,Estoig,Cotxe
Ot Parra Tió: Llibre
Alfons Jové Oliveras: Llibre de dibuixos,Cotxe,Conillet rosa
Susanna Taberner Luque: Torró,Jersei
Queralt Jodar Mascarell: Sabates
Paco Pericas Alba: Llapissos,Caramels,Manta,Joc de taula,Galetes,Ulleres de sol
Cristian Palau Gual: Llibre,Biberó,Mocador de coll,Nina bebé,Còmic,Calendari
Joaquim Marsany Pairó: Guerrer amb espasa,Corbata,Sabates
Diego Brau Ingla: Espasa de fusta,Llibreta,Jaqueta,Disc de música,Os de peluix
Pol Marlés Medina: Retallable,Nina bebé,Llibreta,Nina rossa
Ot Maruny Laborda: Sabons,Còmic
Magda Guilella Jiménez: Bufanda,Guants,Jersei,Casa de nines
Sam Peret Moya: Espasa de fusta
Iu Mascarell Navajas: Nina bebé,Rellotge,Calendari,Mocador de coll
Met Parra Ruiz: Escacs,Mòbil,Cowboy
Carles Matarodona Montràs: Escacs,Ulleres de sol,Ràdio,Guants,Casa de nines
Didac Montràs Roure: Llibre de dibuixos
Bernat Masolivé Llorens: Bufanda,Ulleres de sol,Caramels
Aina Llansana Llanet: Ulleres de sol,Mitxons
Cristian Pinot Parer: Ulleres de sol,Llibreta,Sabates,Bicicleta
Homer Ordeig Maymó: Escacs,Rellotge,Llibreta,Jaqueta
Helena Llorens Petit: Gorro,Calendari
Jean Navajas Roure: Llapissos
Queralt Terrats Paraire: Disc de música
Anna Nogué Marín: Corbata,Cotxe elèctric,Estoig,Arc i fletxes
Zeus Llansana Serra: Cowboy,Retallable,Mitxons,Ràdio,Nina morena,Gorro
Baldiri Guasch Lladó: Llibre de dibuixos,Caramels,Capsa de bombons,Jaqueta
Cesc Medina Laborda: Capsa de bombons,Jaqueta,Calendari,Sabates
Fe Pedrol Petit: Ulleres de sol
Josep Pericas Lluch: Llibre,Rellotge,Llibreta,Nina morena
Toni Albiol Oliveras: Capsa de bombons,Sabons,Nina morena,Guants,Espasa de fusta
Lluis Masmitjà Hernández: Televisor,Biberó,Llibre de dibuixos,Capsa de bombons,Cadireta,Colònia
David Bru Mont: Os de peluix,Calendari
Cristian Vilamoll Maginet: Espasa de fusta,Disc de música,Sabates,Estoig
Cristian Piqueras Visent: Televisor,Nina bebé,Rellotge,Joc de taula,Espasa de fusta
Charly Piferrer Mínguez: Manta,Bossa de mà,Estoig,Cadireta,Disc de música,Cotxe
Bernat Masllorens Guevara: Televisor,Tren,Bossa de mà,Puzzle,Ràdio,Colònia
Jesus Piqueras Masllorens: Bossa de mà,Jaqueta,Bicicleta
Paco Mata Palop: Arc i fletxes
Anna Hosta Jiménez: Capsa de bombons,Arc i fletxes
Marti Mínguez Pedreño: Jersei
Max Masclans Llort: Televisor,Llibre,Rellotge,Jersei,Gorro,Os de peluix
Gerard Agulla Pallejà: Manta
Filomenu Armengol Llucià: Biberó,Mitjons,Joc de taula,Arc i fletxes
Ernest Isern Molas: Llibre de dibuixos,Llibre,Sabons,Calendari,Bossa de mà
Enric Agulla Llorente: Jaqueta,Guants,Cowboy
Bernarda Miravet Lloberes: Corbata
Maria Lluisa Vinals Hosta: Llapissos,Rellotge,Llibre de dibuixos,Bossa de mà,Puzzle,Ràdio
Queralt Mach Marcu: Llibre de dibuixos,Mocador de coll,Colònia,Nina rossa
Susanna Jara Mancho: Guerrer amb espasa,Cadireta
Josep Antoni Marata Sonet: Nina morena,Nina rossa,Os de peluix
Helena Jaques Viu: Mitxons
Alfons Hosta Maruny: Joc de taula,Jersei,Ordinador,Cotxe
Manel Paradís Oliveras: Rellotge,Os de peluix
Candela Gutierrez Luque: Retallable,Jaqueta
Sam Agulla Brunyol: Llapissos,Sabons,Nina morena,Joc de taula,Nina rossa
Sònia Padilla Codina: Mocador de coll
Maria Lluisa Tió Agulla: Caramels
Mireia Monné Mitjavila: Retallable,Estoig,Jersei
Zeus Giménez Llenas: Sabons,Manta,Calendari
Maria Lluisa Matarodona Montràs: Sabons,Retallable,Estoig,Ràdio,Arc i fletxes,Bufanda
Ot Marín Codina: Llibre,Puzzle,Manta,Calendari,Ràdio
Jou Guevara Marsà: Llibre,Mocador de coll,Jaqueta,Guants
Maria Lluisa March Guilella: Escacs
Didac Tubau Junyent: Retallable,Galetes,Cotxe elèctric,Corbata,Casa de nines
Susanna Macià Montràs: Ulleres de sol
Toni Isern Montroig: Nina rossa,Cadireta
Baldiri Moragues Masvidal: Llibreta,Guerrer amb espasa,Guants,Galetes,Capsa de bombons,Ordinador
Queralt Marti Gutierrez: Ulleres de sol
Lluis Palau Manent: Torró
Víctor Guvern Manyé: Estoig
Víctor Pujol Mancho: Gorro,Mocador de coll,Còmic,Jaqueta,Estoig
Josep Antoni Albí Juanola: Ulleres de sol,Manta,Estoig,Nina rossa
Cristian Jordana Pascal: Ràdio
Sam Albí Montràs: Galetes,Torró,Còmic,Sabates,Nina rossa
Bernarda Palau Moron: Televisor,Casa de nines,Bossa de mà,Bicicleta,Capsa de bombons,Disc de música
Jean Guvern Mans: Bossa de mà,Nina morena,Jersei
Carles Juvany Marcos: Sabons,Llibre de dibuixos,Espasa de fusta,Arc i fletxes,Llibreta,Os de peluix
Joan Josep Manent Morillo: Ulleres de sol,Sabons,Mitjons
Miquel Llort Marcet: Rellotge
Magda Huguet Matute: Televisor,Rellotge,Corbata
Felicitat Armengol Marín: Llibreta
Toni Marlés Lacalle: Còmic,Disc de música
Alfred Isanta Ortiz: Bufanda,Mocador de coll,Biberó,Calendari
Jean Jara Oliva: Llibreta,Puzzle,Capsa de bombons,Calendari,Cotxe
Maria Leal González: Capsa de bombons,Joc de taula
Diego Llofriu Guasch: Mòbil,Ordinador
Marta Jové Rey: Bufanda,Televisor,Casa de nines
Toni Ortiz Llesera: Sabons,Guerrer amb espasa,Espasa de fusta,Escacs,Nina bebé,Bufanda
Mònica Aubert Armengol: Llibre,Gorro,Biberó,Corbata,Televisor
Frederic Miravet Lara: Televisor,Rellotge,Tren,Retallable,Ràdio,Cadireta
Josep Antoni Jornet Albí: Retallable,Nina bebé,Torró,Llibreta
Òscar Palacios Matute: Caramels,Puzzle,Joc de taula,Còmic,Bufanda,Cotxe elèctric
Magda Padilla Jorquera: Guerrer amb espasa
Miquel Laborda Puig: Bossa de mà,Caramels,Guerrer amb espasa,Guants,Calendari
Maria Lluisa Llansana Oliveras: Guants
Alfons Palau Fernàndez: Gorro,Televisor,Llibre,Biberó,Cotxe
Josep Antoni Not Pey: Bufanda,Sabons,Estoig,Tren
Daniel Pericas Manent: Biberó,Tren,Puzzle,Sabates,Nina morena,Cotxe
Mònica Juvany Ortega: Disc de música,Casa de nines
Bernat Masolivé Llatser: Llibre de dibuixos,Nina morena
Met Masvidal Murga: Tren,Espasa de fusta,Casa de nines
Fe Huguet Marata: Mocador de coll,Colònia,Llibreta,Mitxons
Sònia Malla Mancho: Mitxons,Cotxe elèctric,Calendari,Llibreta
Bernat Pinot Raga: Llapissos,Cotxe,Jersei,Cowboy
Maria Lluisa Not Bonastre: Biberó,Cadireta
Pep Jordana Solé: Llibre de dibuixos,Mocador de coll,Mitxons,Jersei,Ràdio,Bufanda
Enric Mínguez Pi: Llibre de dibuixos,Llibreta,Conillet rosa,Calendari
Mònica Marcu Perez: Gorro,Rellotge,Jersei,Nina rossa,Sabons
Frederic Paret Ibarra: Disc de música,Bicicleta
Diego Marti Palop: Ulleres de sol,Manta,Bicicleta
Joan Iglesias Peret: Joc de taula
Cristian Marlés Hom: Nina bebé
Zeus Murga Soler: Casa de nines
Susanna Morillo Marqués: Llibre,Mitjons,Bufanda,Calendari,Gorro,Os de peluix
Toni Molas Mercadé: Nina rossa,Sabates,Joc de taula,Jersei,Os de peluix
Cesc Majós Orobitg: Puzzle,Llibreta,Colònia,Casa de nines,Cadireta
Iu Lladó Medina: Llibre,Colònia,Mitjons,Sabates,Casa de nines
Fe Pericas Viu: Llibre,Colònia,Manta,Casa de nines
Rufo Macrané Majós: Llibreta,Sabates
Met Morral Ubach: Caramels,Ordinador,Conillet rosa
Marti  Maginet: Nina morena,Llibreta
Joaquim Julià Guirao: Cotxe
Pitu Not Armengol: Televisor,Mocador de coll,Colònia,Sabates
Ernest Ortega Cardona: Escacs,Mitxons,Espasa de fusta
Miquel Manzano Maurell: Ulleres de sol,Corbata
Pitu Nogué Pesarrodona: Espasa de fusta
Sergi Piñol Mundó: Còmic,Estoig,Jersei
Filomenu Picanyol Hosta: Caramels,Jaqueta,Mitjons,Sabates
Aina Paret Alba: Jersei,Ordinador,Cotxe
Helena Guixà Vives: Torró
Antonia Bonaterra Jordana: Ordinador,Tren
Frances Llucià Parer: Jersei,Joc de taula,Tren
Merce Maluquer Pericas: Disc de música,Ordinador
Diego Brunyol Agulla: Llapissos,Manta,Conillet rosa
Frances Cardona Cardona: Casa de nines,Guerrer amb espasa,Calendari,Galetes,Ulleres de sol,Llibreta
Maria Marcu Llabot: Bufanda,Còmic,Estoig,Conillet rosa,Mitjons
Cristian Platja Morral: Colònia,Nina morena,Cowboy,Llibreta,Cadireta
Pitu Ricart Marlés: Gorro,Llapissos,Rellotge,Jaqueta,Disc de música
Zeus Visent Fernàndez: Mitjons
Jean Palop Jorquera: Bufanda,Mocador de coll,Tren,Jaqueta,Mòbil
Didac Albiol Boix: Ulleres de sol,Cotxe elèctric,Sabates,Cotxe,Cadireta
Jou Navajas Pelegrí: Sabons,Conillet rosa,Mitxons,Calendari,Ulleres de sol,Disc de música
Pitu Alemany Manent: Nina morena,Nina rossa,Arc i fletxes
Pitu Navajas Llabot: Guerrer amb espasa,Sabates,Gorro,Cadireta,Escacs,Cotxe elèctric
Víctor Manyé Jodar: Llibre de dibuixos,Bossa de mà,Guerrer amb espasa,Colònia
Aina Masvidal Palomera: Retallable,Ulleres de sol,Guerrer amb espasa,Estoig,Calendari
Homer Pelayo Masachs: Galetes,Ulleres de sol
Bernat Fernàndez Nogué: Manta
Aina Hernández González: Llibre,Corbata,Bossa de mà,Mitxons,Nina bebé,Nina morena
Iu Llach Casajuana: Televisor,Còmic,Bicicleta
Joan Taberner Pey: Escacs,Jersei,Sabates,Arc i fletxes
Cristian Sabater March: Llibre,Llibreta,Puzzle,Mitjons,Capsa de bombons,Disc de música
Sam Jové Mayans: Cotxe elèctric
Jean Pallejà Masllorens: Mitxons,Bicicleta
Joanot Piñol Hom: Jaqueta,Bossa de mà,Arc i fletxes,Bufanda,Llibreta,Ordinador
Bernat Hom Albí: Llibre de dibuixos,Gorro,Guants,Estoig,Casa de nines
Frances Masolivé Bonaterra: Escacs,Mocador de coll,Jaqueta,Sabates
Charly Marcó Lloberes: Rellotge,Còmic,Os de peluix
Cesc Mundó Visent: Casa de nines
Ernest Montià Malla: Llibre,Caramels,Cowboy,Mitxons,Rellotge,Os de peluix
Joanot Palop Llorens: Puzzle,Llibreta
Jesus Juanola Pinyas: Sabons,Cotxe elèctric,Os de peluix
Antonia Llenas Bonastre: Gorro,Llapissos,Biberó,Guants,Calendari
Merce Peret Masachs: Espasa de fusta,Casa de nines
Mireia Jordana Icart: Puzzle
Iu Soler Jové: Escacs,Bufanda,Puzzle,Guants,Calendari
Charly Lladó Guixà: Televisor,Llapissos,Biberó,Jersei
Maria Oliveras Mitjavila: Galetes,Ulleres de sol,Caramels,Calendari,Nina bebé
Met Paula Mont: Nina bebé,Sabons,Llibreta,Ordinador,Nina rossa
Josep Antoni Masmitjà Iglesias: Televisor,Conillet rosa,Cowboy,Mòbil,Calendari,Colònia
Marta Gual Raga: Sabons,Cowboy,Llibre de dibuixos,Caramels,Arc i fletxes,Capsa de bombons
Frederic Manent Manyé: Llapissos,Rellotge,Guerrer amb espasa,Manta,Os de peluix
Helena Tió Mach: Mocador de coll
Iu Ibarra Visent: Televisor,Ulleres de sol,Guants,Corbata
Max Llanet Margalef: Galetes,Escacs,Llibreta,Estoig,Disc de música
Sònia Petit Soler: Conillet rosa,Galetes,Corbata,Jersei
Quim Paladell Pey: Manta,Mocador de coll,Mitxons,Sabates,Nina rossa,Galetes
Angela Giménez Perez: Mòbil,Os de peluix,Conillet rosa,Capsa de bombons,Disc de música,Cotxe
Bernat Oliva Montià: Llibre,Nina bebé,Puzzle,Tren
Cesc Pou Mallafré: Colònia,Guants,Cowboy
Zeus Jové Casajuana: Llibreta,Os de peluix
Pitu Mitjavila March: Mòbil,Arc i fletxes
Alfons Pia Macrané: Televisor,Caramels,Tren,Retallable,Ràdio,Ordinador
Josep Jorba Pallejà: Capsa de bombons,Calendari
Jean Rodríguez López: Jaqueta,Sabates,Llibre de dibuixos,Joc de taula,Jersei,Nina rossa
Frederic Isern Marcu: Llibre,Torró,Corbata,Jersei
Pitu Pesarrodona Medina: Mòbil,Bicicleta
Toni Masdefiol Giménez: Mocador de coll,Llibreta
Enric Marot Llofriu: Mocador de coll,Jaqueta,Ulleres de sol
Ot Julià Mach: Galetes,Mòbil,Caramels,Llibreta,Casa de nines
Pepa Marqués Marsany: Nina bebé,Guerrer amb espasa,Colònia,Joc de taula,Os de peluix
Baldiri Lozano Moya: Nina bebé,Caramels,Estoig,Bicicleta
Toni Majós Martell: Torró
Quim Monné Fernàndez: Biberó
Quim Bonastre Oliva: Llapissos,Sabons,Jaqueta,Espasa de fusta
Marti Laborda Monells: Escacs,Puzzle,Manta,Ordinador
Marta Pinyas Mitjavila: Caramels,Còmic
Joaquim Pelayo Moron: Llibreta,Guerrer amb espasa,Cotxe elèctric,Sabates,Calendari
Diego Masdefiol Molas: Guerrer amb espasa,Capsa de bombons
Cesc Pitarch Viu: Mocador de coll,Capsa de bombons,Disc de música,Estoig
Pepa Peret Maurell: Biberó,Manta,Cowboy,Retallable,Arc i fletxes,Escacs
Quim Pia Mancho: Galetes,Mitxons,Mitjons
Angela Pi Marín: Cotxe elèctric
Josep Antoni Latre Taberner: Televisor,Cotxe elèctric,Guants,Joc de taula,Còmic,Colònia
Josep Antoni Lloris Guimerà: Llibre de dibuixos,Torró,Còmic
Felicitat Alba Pinyas: Llibre
Rufo Padrosa Macrané: Jaqueta,Llibre de dibuixos,Mòbil,Puzzle,Sabates,Ràdio
Pepa Palomera Petit: Bossa de mà,Sabons
Helena Oliveras Mancho: Nina morena,Sabons,Colònia,Estoig,Puzzle
Alfons Masvidal Marín: Gorro,Nina bebé,Espasa de fusta
Fe Mont Bru: Escacs,Televisor
Max Guvern Margalef: Calendari
Manel Llansana Armengol: Llibre de dibuixos
Joanot Roure Pi: Llibre de dibuixos,Cotxe elèctric,Calendari
Josep Pascal Guardiola: Bossa de mà,Biberó,Ordinador,Sabates,Bicicleta
Jou Navajas Guvern: Torró,Espasa de fusta,Casa de nines
Aina Rodríguez Jaques: Rellotge,Puzzle
Jean Masachs Malé: Llibre,Sabons,Llibreta
Joanot Llach Moron: Mocador de coll,Estoig,Jersei,Sabates,Conillet rosa,Disc de música
Angela Bonastre Negre: Bossa de mà,Os de peluix
Homer Juncosa Llansana: Sabons,Llibreta,Jaqueta,Estoig
Ot Jaques López: Televisor,Rellotge,Biberó,Retallable,Mitxons,Còmic
Baldiri Tubau Pellicer: Sabons,Caramels,Ràdio
Aina Maymó Palop: Nina rossa
Joan Josep Leal Matamala: Televisor,Ulleres de sol,Rellotge,Ordinador,Calendari
Bernarda Peret Maruny: Bufanda,Nina rossa
Enric Jornet Palomera: Televisor,Estoig,Disc de música
Manel Albí Guirao: Escacs,Llibreta,Disc de música,Calendari
Carles Pou : Llibre de dibuixos,Guerrer amb espasa,Mitjons,Sabates,Bufanda,Ordinador
Anna Junyent Laborda: Gorro,Bossa de mà,Llibreta
Iu Mínguez Jové: Llibre de dibuixos,Ulleres de sol,Mitxons,Corbata,Ràdio
Daniel Manent Lluch: Escacs,Sabons,Manta,Caramels,Espasa de fusta
Iu Martell Padrosa: Jaqueta,Casa de nines,Retallable,Mocador de coll,Calendari,Gorro
Cesc Majós González: Estoig
Alfred Hernández Mata: Televisor,Llapissos,Llibreta,Guerrer amb espasa,Nina rossa,Cotxe elèctric
Didac Parer Miravet: Puzzle,Caramels
Susanna Llanet Miravet: Televisor,Torró,Cowboy
Pol Molas Guasch: Ordinador,Sabates
Cristian Leal Masana: Mòbil,Corbata,Ràdio,Disc de música,Arc i fletxes
Zeus Oliva Montió: Torró,Colònia,Manta
Paco Jara Puig: Televisor
Lluis Lara Jiménez: Galetes,Televisor,Ordinador,Estoig
Sam Tubau Maymó: Nina rossa,Mòbil,Mitjons,Conillet rosa,Arc i fletxes
Mireia Bru Pedreño: Llibre de dibuixos,Caramels,Manta
Joaquim Murga Lloris: Televisor,Ulleres de sol,Cotxe elèctric,Cadireta
Enric Llesera Ruiz: Ulleres de sol,Còmic,Jaqueta,Nina rossa,Arc i fletxes
Baldiri Nogué Maginet: Rellotge,Casa de nines,Caramels,Cotxe,Cowboy
Alfons Maurell Laborda: Biberó,Bicicleta,Escacs,Galetes,Bufanda,Cotxe elèctric
Candela Jorquera Marín: Bossa de mà,Nina bebé,Cotxe,Cowboy
Charly Pia Llansana: Escacs,Ulleres de sol,Espasa de fusta,Bicicleta
Cristian Llobet Messegué: Estoig,Guerrer amb espasa,Calendari,Jersei,Tren
Quim Sonet Ibarra: Retallable,Capsa de bombons,Casa de nines
Miquel Codina Llucià: Bossa de mà,Manta,Nina rossa
Pitu Maruny Llanet: Gorro,Espasa de fusta,Cowboy
Pere Montió Paret: Corbata,Sabates,Arc i fletxes
Pep Albí Llansana: Guants,Jersei,Sabates,Casa de nines
Merce Picanyol Morral: Retallable,Llibre,Joc de taula,Sabates,Mitjons
Pere Parra Masdefiol: Mitjons
Queralt Julià Mascarell: Sabons,Nina morena,Espasa de fusta,Cadireta
Maria Guilella Llabot: Retallable,Ulleres de sol,Conillet rosa,Llibre de dibuixos
Mireia Moron Jodar: Puzzle,Caramels,Cotxe,Cadireta
Carles Pastoret Morillo: Caramels,Disc de música,Calendari
Joan Guilella Masachs: Llibre de dibuixos,Nina morena
Mònica Mont Molas: Conillet rosa,Tren
Alfons Mayné Laborda: Retallable,Conillet rosa,Joc de taula,Cadireta
Candela Padrosa Llucià: Llibre de dibuixos,Mitxons,Mitjons,Nina rossa,Cadireta,Capsa de bombons
Paco Matarodona Solé: Galetes,Nina bebé,Jaqueta,Calendari,Ràdio
Toni Perez Masachs: Sabons,Jaqueta,Retallable,Rellotge,Jersei,Escacs
Pepa Cardona Pijoan: Sabons,Caramels,Mitjons
Didac Pont Pairó: Llibre,Ulleres de sol,Cotxe elèctric,Corbata,Disc de música
Maria Guvern Masdefiol: Ràdio
Anna Pitarch Mallafré: Mocador de coll,Mitjons,Joc de taula,Nina bebé,Conillet rosa,Gorro
Enric Terrats Gual: Tren,Llibreta,Calendari,Casa de nines
Queralt Mans Manent: Nina bebé,Guerrer amb espasa
Fe Junyent Gual: Sabons
Pol Moron Bonastre: Puzzle,Llibreta,Casa de nines
Miquel Junyent Maymó: Sabates
Joanot Pellicer Llabot: Retallable,Mocador de coll,Puzzle,Guerrer amb espasa,Os de peluix
Ernest Macià Masvidal: Ulleres de sol,Caramels,Torró,Ordinador
Pol Piñol Medina: Mocador de coll,Llapissos,Mitjons,Joc de taula,Sabates
Helena Latre Llenas: Joc de taula
Sam Marcó Pallejà: Retallable,Còmic,Estoig,Espasa de fusta
Mònica Leal Julià: Llibre,Sabons,Jersei,Rellotge,Sabates
Marta Icart Macià: Nina bebé,Disc de música
Helena Jové Pijoan: Escacs
Mireia Masllorens Tió: Mocador de coll,Sabons,Ordinador
Pitu Llucià Mitjavila: Rellotge,Corbata,Retallable,Guerrer amb espasa,Sabons,Sabates
Alfons Paula Guirao: Llibre de dibuixos,Jersei,Ràdio
Maria Marsà Alba: Televisor,Bossa de mà
Josep Antoni Icart Parra: Capsa de bombons
Baldiri Taberner Jorquera: Gorro,Nina bebé,Puzzle,Llibre
Lluis Pericas Ortega: Nina bebé
Marta Jorquera Morillo: Caramels,Ràdio
Jesus Guirao Olivella: Sabons,Cowboy,Llibre de dibuixos,Mòbil,Escacs,Galetes
Ernest Pedreño Marata: Mitxons
Manel Murga Páramo: Bufanda,Disc de música,Nina rossa
Charly Not Guardiola: Televisor,Mitjons,Espasa de fusta
Anna Magrinyà Albí: Galetes,Mòbil,Llibreta,Corbata
Quim Laborda Armengol: Llibreta,Arc i fletxes
Helena Maluquer Padrosa: Joc de taula
Víctor Not Junyent: Llibre de dibuixos,Bossa de mà,Llibreta,Disc de música
Magda Lloberes Paula: Llapissos,Corbata,Joc de taula,Bicicleta
Maria Paladell Nogué: Còmic,Casa de nines
Diego Lacalle Puig: Gorro,Mòbil,Estoig
Anna Paret Masdefiol: Biberó,Conillet rosa
Maria Lluisa Perez Raga: Còmic,Llibreta
Carles Lara Gasull: Mocador de coll,Colònia,Jaqueta,Os de peluix,Cadireta
Joaquim Gasull Visent: Sabons
Òscar Paladell Montràs: Bufanda,Capsa de bombons,Os de peluix
Mònica Maurell Guvern: Còmic
Bernarda Guimerà Pinyas: Sabons,Sabates
Jou Sabater Moya: Arc i fletxes
Òscar Leal Guilella: Sabons
Daniel Junyent Fernàndez: Torró,Llibre,Còmic,Estoig,Nina morena
Mireia Navajas Guilella: Escacs,Jersei
Víctor Petit Pinyas: Llibre,Retallable,Llibreta,Jaqueta
Xavier Pijoan Llorens: Escacs,Llapissos,Cotxe,Espasa de fusta,Arc i fletxes
Merce Bonaterra Mach: Rellotge,Manta,Sabates
Òscar Pelegrí Jaques: Còmic
Pere Maginet Macià: Nina bebé,Cadireta
Jou Perez Medrano: Mocador de coll,Còmic
Joaquim Vilamoll Tubau: Jersei
Rufo Manzano Mayné: Mòbil,Guerrer amb espasa,Guants,Conillet rosa,Cadireta,Capsa de bombons
Enric Boix Marsà: Còmic
Miquel Margalef Sonet: Corbata,Rellotge,Nina rossa,Jersei,Estoig
Didac Masmitjà Brau: Mocador de coll,Rellotge,Sabates,Os de peluix
Zeus Malé Taberner: Sabons,Caramels,Sabates
Maria Jorba Juvany: Rellotge,Cowboy,Estoig,Calendari,Bicicleta
Toni Paladell Guvern: Gorro,Torró,Jaqueta,Nina morena,Sabates
Didac Llabot Olivella: Llibreta,Mitjons,Espasa de fusta
Helena Pedrol Brau: Gorro,Llibre de dibuixos,Llibreta,Manta,Nina rossa
Met Alcoberro Jordana: Ordinador,Joc de taula,Cadireta
Cristian Mercadal Jové: Capsa de bombons,Cotxe,Casa de nines
Queralt Ubach Lozano: Llapissos,Cotxe elèctric,Retallable,Guerrer amb espasa,Cadireta,Capsa de bombons
Frances Casajuana Mancho: Mocador de coll
Gerard Medrano Mitjavila: Gorro,Caramels,Bicicleta
Anna Mayans Paraire: Ulleres de sol,Mitjons
Antonia Masolivé Brau: Gorro,Bufanda,Rellotge,Torró,Bicicleta
Enric Mascarell Isern: Bufanda,Gorro,Colònia,Retallable,Tren
Xavier Julià Leal: Guerrer amb espasa,Jaqueta,Corbata,Casa de nines
Toni Malla Albí: Torró,Capsa de bombons,Biberó,Ordinador,Bossa de mà
Víctor Llucià Montià: Galetes,Mitjons,Joc de taula
Pere Pinot Morillo: Nina bebé,Mitxons,Sabates,Ràdio
Sam Montràs Paret: Tren,Cotxe elèctric,Casa de nines
Enric Martell Casajuana: Mitjons
Josep Paradís Palacios: Ulleres de sol
Candela Orobitg Lladó: Sabates
Candela Jornet Junyent: Nina bebé
Sergi Paradís Leal: Llibre de dibuixos,Mòbil,Puzzle,Cotxe elèctric
Miquel Sabater Pont: Televisor,Bicicleta
Sònia Mula Jové: Galetes,Puzzle,Ordinador,Os de peluix,Casa de nines
David Navajas Pijoan: Còmic,Sabates,Os de peluix
Lluis Ortiz Manyé: Retallable,Puzzle,Biberó,Nina morena,Calendari
Aina Guimerà Llatser: Disc de música,Os de peluix,Estoig
Bernat Masdevall Sabater: Espasa de fusta
Josep Agulla Luque: Llibre,Ulleres de sol,Còmic,Ordinador,Llibre de dibuixos
Fe Margalef Juvany: Guerrer amb espasa,Llibreta,Conillet rosa,Bicicleta
Sam Vinals Palop: Nina morena,Torró,Jersei,Corbata,Llibreta
Homer Maluquer Pedreño: Mocador de coll,Cadireta,Bossa de mà,Mitxons,Ràdio
Jesus Medrano Medina: Ulleres de sol
Homer Alba Ortiz: Guants,Ordinador
Frances Masolivé Jodar: Cotxe,Joc de taula
Quim Ruiz Macrané: Mitjons
Lluis Pallarol Lloberes: Corbata,Jersei
Joan Masolivé Pedrol: Gorro,Mocador de coll,Manta
Sam Lloris Mont: Mitxons,Corbata,Nina rossa,Cadireta
Ot Marqués Solé: Caramels,Bicicleta,Nina morena,Conillet rosa,Cadireta,Ulleres de sol
Pitu Marqués Pallejà: Escacs,Televisor,Nina rossa,Sabates,Mòbil
Jean Ordeig Huguet: Torró,Caramels,Còmic
Frances Jorba Padrosa: Cotxe elèctric,Nina morena,Cotxe,Ràdio
Baldiri Albiol Hom: Bufanda,Llibre,Colònia,Torró,Nina rossa
Mireia Moron Pinot: Ulleres de sol,Ràdio
Bernarda Aubert Vinals: Gorro,Llapissos,Ràdio
Marti Pi Llesera: Retallable,Torró,Conillet rosa,Cotxe,Mitjons
Jesus Not González: Sabons,Colònia,Disc de música,Os de peluix,Mitjons
David Pont Manzano: Biberó
Alfons Alba Serra: Gorro,Nina bebé,Caramels,Colònia,Còmic
Josep Antoni Marcó Pinyas: Retallable,Llibre de dibuixos,Sabons,Capsa de bombons,Mocador de coll
Mònica Petit Paraire: Televisor,Rellotge,Calendari,Sabates,Conillet rosa,Galetes
David Llatser Peret: Gorro
Joan Oliveras Codina: Nina bebé,Colònia,Nina rossa,Jersei,Biberó
Joaquim Sabater Gual: Retallable,Llapissos,Espasa de fusta,Tren
Joaquim Pedrol Gasull: Rellotge
Angela Mascarell Manzano: Cadireta,Guants,Estoig,Sabates,Bicicleta
Mònica Marsany Perez: Capsa de bombons
Jou Peret Moya: Sabates,Caramels,Corbata,Jersei
Pitu Marata Rodríguez: Llibre,Llibre de dibuixos,Nina bebé,Arc i fletxes,Llibreta,Disc de música
Gerard Parer Maldonado: Biberó,Retallable,Mòbil,Jersei,Còmic,Torró
Homer Mula Armengol: Llibreta,Mòbil,Cowboy,Mocador de coll,Cadireta,Capsa de bombons
Met Jordana Masachs: Sabates
Magda Viu Sabater: Bossa de mà,Colònia,Llibreta,Calendari
Fe Iglesias Moron: Bufanda,Llapissos,Calendari,Corbata,Jersei
Joan Marqués Macià: Bufanda,Sabons,Torró,Nina rossa,Cowboy
Cesc Ingla Piqueras: Puzzle,Llibreta,Nina morena
Sònia Marcos Montià: Televisor,Sabons,Biberó,Bossa de mà,Mitxons,Cadireta
Frederic Juncosa Picanyol: Escacs,Llibre,Cotxe elèctric,Cotxe
Daniel Tubau Martell: Guants,Jersei,Bicicleta
Josep Petrus Ibarra: Televisor,Sabates,Ordinador,Cotxe elèctric,Disc de música,Os de peluix
Joaquim Llesera Pallejà: Corbata
Jou Macià Lloberes: Còmic,Jaqueta,Tren
Max Alba Mercadal: Llibreta,Os de peluix
Víctor Julià Piñol: Bossa de mà,Ulleres de sol
Rufo Masllorens Masvidal: Guants,Rellotge,Llibreta,Jaqueta,Bossa de mà
Toni Not Paret: Nina bebé,Cotxe elèctric,Ordinador,Bicicleta
Mònica Llobet Lladó: Ulleres de sol,Ràdio,Calendari,Llapissos
Pepa Lozano Masdefiol: Galetes,Ulleres de sol,Jaqueta,Sabates
Angela Parra Tubau: Caramels
Pitu Mallafré Juanola: Televisor,Llibreta,Manta,Nina rossa,Sabates
Daniel Matarodona Llach: Llibre,Ulleres de sol,Cotxe,Nina bebé
Antonia Guvern Pujol: Retallable,Ràdio
Bernarda Puig Pairó: Llibreta
Max Juanola Oliva: Llibreta,Còmic,Corbata
Joan Morral Nogué: Retallable,Mòbil,Còmic,Disc de música,Cowboy
Didac Pericas Lladó: Disc de música,Arc i fletxes
Baldiri Huguet Pi: Gorro,Bossa de mà,Nina bebé,Nina rossa,Cadireta
Josep Marata Montió: Mòbil,Sabates,Bicicleta
Daniel Guvern Aubert: Rellotge,Còmic,Manta,Cotxe
Joanot Montràs Marcu: Corbata,Cotxe
Pol Pujol Matamala: Sabons,Mitxons,Cotxe elèctric
Candela Hernández Lluch: Bufanda,Nina bebé,Guerrer amb espasa
Xavier Palomera Viu: Llibre de dibuixos,Escacs,Puzzle,Manta,Tren
Didac Petit Ortiz: Mòbil,Jaqueta,Joc de taula,Conillet rosa
Merce Platja Navajas: Disc de música
Víctor Montió Bru: Galetes,Guerrer amb espasa,Biberó,Cowboy
Zeus Armengol Marti: Ordinador
Pitu Peret Mercadé: Rellotge,Os de peluix
Angela Perez Pascal: Galetes,Nina morena,Jaqueta,Ordinador,Arc i fletxes
Susanna Pinot Llatser: Biberó,Estoig,Calendari
Frances Solé Manzano: Retallable,Nina rossa,Jaqueta,Ordinador,Os de peluix
Mireia Lluch Monells: Estoig
Angela Navajas Vinals: Galetes,Bicicleta,Cotxe,Ràdio
Charly Macià Llucià: Bufanda,Cadireta,Torró,Cotxe elèctric,Arc i fletxes
Manel Piqueras Llenas: Llibre,Espasa de fusta,Cowboy
Gerard Jorquera Lloberes: Mòbil,Caramels,Llibreta,Calendari,Cowboy
Candela Paradís Maruny: Gorro,Cotxe
Magda Masmitjà Mach: Gorro,Nina morena
Maria Navajas Isern: Nina bebé,Espasa de fusta,Sabates,Ordinador
Toni Sabater Piqueras: Mitxons
Cesc Llauradó Jiménez: Biberó
Josep Antoni Peret Jaques: Retallable,Televisor,Nina morena
Zeus Medina Montroig: Colònia,Jaqueta,Calendari,Nina rossa,Tren
Alfons Marcu Juncosa: Cadireta,Rellotge,Llibreta,Cowboy
Diego Pascal Bru: Llibre
Jesus Mínguez Masdevall: Retallable,Escacs,Llibreta,Mitjons,Disc de música
Max Marcu Masolivé: Gorro,Os de peluix
Zeus Mercadé Boix: Llapissos,Cotxe elèctric
Joan Pastoret Moragues: Retallable,Sabons,Espasa de fusta,Bicicleta
Aina Masachs Pesarrodona: Bufanda,Ulleres de sol,Retallable,Nina rossa,Tren
Didac Giménez Masachs: Mocador de coll,Espasa de fusta
Mònica Masvidal Ruiz: Llapissos,Colònia,Guerrer amb espasa
Baldiri Pelegrí Moron: Bufanda,Nina morena,Guants,Calendari,Jersei
Angela Magrinyà Soler: Cotxe elèctric,Disc de música
Baldiri Malé Codina: Gorro,Nina bebé,Biberó,Cotxe,Cowboy
Òscar Gasull Ingla: Televisor,Còmic
Frances Mallafré Lozano: Llapissos,Puzzle,Llibreta
Cristian Lloberes Mercadé: Bossa de mà,Conillet rosa
Antonia Marata Pesarrodona: Capsa de bombons,Sabates
Felicitat Bonastre Monné: Llibre,Casa de nines,Mòbil,Sabates,Conillet rosa,Colònia
Filomenu Montroig Parer: Escacs,Bossa de mà,Sabons,Mocador de coll
Pol Junyent Manyé: Bufanda,Guants,Cadireta
Joan Picanyol Manent: Mitxons,Cotxe elèctric,Conillet rosa,Llibreta,Cowboy
Max Viu Monells: Biberó,Jaqueta,Guants,Nina bebé,Bufanda,Ordinador
Helena Palomera Llanet: Galetes,Llapissos,Còmic,Nina rossa
Filomenu Bonaterra Parer: Gorro,Retallable,Còmic,Bicicleta
Diego Bru Maurell: Os de peluix
Anna Llorente Guilella: Còmic,Guants,Calendari,Nina rossa
Josep Llesera Albí: Nina bebé,Torró,Cadireta
Alfons Taberner Pedrol: Escacs,Guerrer amb espasa,Mitxons,Mitjons,Cotxe elèctric
Joan Josep Monells Marcet: Llibre de dibuixos,Ulleres de sol,Nina morena,Disc de música,Jersei
Víctor Paladell Llobet: Televisor,Llibre,Colònia,Casa de nines,Cowboy
Toni Martell Mundó: Televisor,Llibre de dibuixos,Casa de nines,Sabates,Bicicleta
Miquel Marlés Hosta: Puzzle,Corbata,Nina rossa
Aina Mitjavila Palau: Escacs,Calendari,Joc de taula,Bicicleta
Pitu Bru Moron: Gorro,Llibre de dibuixos,Rellotge,Colònia
Met Mercadal Latre: Retallable,Llapissos,Caramels,Torró,Jaqueta
Max Morral Mont: Torró,Biberó,Ordinador
Frederic Not Martell: Jersei,Espasa de fusta,Disc de música,Sabates,Cowboy
Bernat Maldonado Guimerà: Bufanda,Jaqueta
Joaquim Matute Marcu: Jaqueta,Guerrer amb espasa,Manta,Estoig,Mitjons
Candela Llucià Albiol: Escacs,Llapissos,Jaqueta,Estoig,Conillet rosa
Didac Taberner Tió: Bossa de mà,Còmic,Estoig,Conillet rosa,Nina bebé
Zeus Maruny Bonastre: Bufanda,Llibreta,Estoig,Conillet rosa
Mireia Llach Albiol: Puzzle,Tren
Víctor Bru Masmitjà: Manta
Toni Morral López: Capsa de bombons,Jaqueta,Nina morena
Queralt Maymó Montràs: Llibre,Mòbil,Bicicleta,Nina bebé,Bufanda,Disc de música
Didac Llorente Morral: Rellotge,Estoig,Ordinador,Nina morena,Llibreta,Disc de música
Miquel Pedrol Moron: Rellotge,Arc i fletxes
Candela Martell Mercadé: Gorro,Cotxe elèctric,Llibreta,Joc de taula
Sergi Maruny Guimerà: Ulleres de sol,Llibreta
Pol Matute Llansana: Gorro,Retallable,Disc de música
Anna Palau Negre: Mocador de coll,Biberó,Nina rossa,Joc de taula,Mòbil
Pol Llort Agulla: Caramels
Joan Guilella Lladó: Ulleres de sol,Rellotge,Nina morena,Ordinador,Espasa de fusta
Sergi Fernàndez Peret: Jaqueta,Corbata,Casa de nines,Bicicleta,Ràdio,Cotxe elèctric
Xavier Malla Albiol: Televisor,Nina morena,Joc de taula,Biberó
Joanot Masachs Palau: Colònia,Espasa de fusta,Bicicleta
Maria Lluisa Masolivé Hom: Ulleres de sol,Llibreta,Conillet rosa,Nina rossa,Mitxons
Enric Peret Roure: Arc i fletxes
Maria Oliva Marcet: Cowboy
Toni Masdefiol Guimerà: Cotxe elèctric
Candela Bonastre Marsà: Gorro,Nina bebé,Bicicleta
Baldiri Llorente Marot: Sabons,Còmic,Bicicleta
Helena Parra Solé: Guerrer amb espasa,Torró,Corbata
Pep Icart Agulla: Nina morena,Conillet rosa
Alfred Marcu Bonastre: Cadireta,Nina rossa,Bicicleta
Homer Navajas Masvidal: Capsa de bombons
Bernarda Vives Marcet: Llibreta,Calendari
Lluis Marot Jordana: Gorro,Jaqueta
Sam Iglesias Sabater: Llibreta,Mòbil,Televisor,Capsa de bombons,Jersei
Sònia Majós Peret: Bossa de mà,Capsa de bombons,Casa de nines,Mòbil
Sònia Marata Llofriu: Caramels,Ràdio,Estoig,Joc de taula,Bicicleta
Bernarda Padilla Guvern: Ulleres de sol,Ràdio,Guants,Nina bebé
Alfred Guixà Montràs: Ulleres de sol,Calendari,Sabates,Casa de nines
Joanot Marsany Pallejà: Jaqueta
Carles Pallarol Llansana: Televisor,Mòbil,Guerrer amb espasa,Joc de taula,Bicicleta,Llibreta
Josep Matamala Moya: Nina bebé,Mitxons,Ordinador,Espasa de fusta,Corbata
Frederic Albí Macrané: Mitxons
Diego Juncosa Petrus: Espasa de fusta,Calendari
Jean Orobitg Iglesias: Colònia,Espasa de fusta,Estoig,Cotxe,Arc i fletxes
Joan Josep Brunyol Paret: Llibre de dibuixos,Bicicleta,Guerrer amb espasa,Calendari,Ràdio
Maria González Marsà: Galetes
Queralt Llauradó Pitarch: Corbata,Cowboy,Espasa de fusta,Arc i fletxes,Llibreta,Disc de música
Mònica Pont Lozano: Galetes,Guerrer amb espasa,Nina rossa,Os de peluix
Pitu Llorente Llorente: Televisor,Colònia,Sabates,Os de peluix
Queralt Hom Paladell: Sabons,Capsa de bombons,Mitxons,Biberó,Conillet rosa,Llibreta
Alfons Lladó Taberner: Llibre,Escacs,Disc de música,Os de peluix
Marta Platja Juvany: Bufanda,Colònia,Estoig,Espasa de fusta
Carles Montió Guardiola: Estoig
Charly Jorquera Raga: Retallable,Corbata,Joc de taula
Marta Bru Not: Televisor,Caramels,Torró,Nina rossa,Ràdio
Queralt Martell Manyé: Calendari,Espasa de fusta
Antonia Leal Gutierrez: Capsa de bombons,Espasa de fusta
Pere Paraire Agulla: Llibre,Galetes,Guerrer amb espasa,Nina morena,Bicicleta
Lluis Paradís Macià: Retallable,Cotxe,Espasa de fusta
Jean Junyent Hom: Biberó,Manta,Mocador de coll,Jersei,Nina rossa,Llibreta
Queralt Mínguez Paladell: Corbata,Os de peluix
Susanna Olivella Bonaterra: Rellotge,Llibreta
Manel Taberner Vinals: Retallable,Rellotge,Manta,Mitjons
Diego Llorens Pijoan: Retallable,Mocador de coll,Caramels,Còmic,Sabates
Charly Casajuana Masdefiol: Llapissos
Joan Guardiola Miravet: Cotxe elèctric,Mitjons
David Mercadé Ricart: Calendari,Casa de nines,Llibre de dibuixos,Tren,Conillet rosa,Gorro
Alfons Aubert Albiol: Mitxons,Manta,Ordinador,Calendari,Biberó
Rufo Not Lloberes: Retallable,Nina bebé,Ordinador,Jersei
Pitu Terrats Juanola: Llibre
Alfons Parer Maginet: Sabons,Cotxe elèctric,Estoig
Marta Hernández Guixà: Cotxe,Cadireta,Estoig,Sabates,Casa de nines
Alfons Llorens Molas: Ulleres de sol,Rellotge,Còmic,Guants,Llibreta
Helena Not Piferrer: Televisor,Biberó,Ràdio,Còmic,Gorro,Llibreta
Joan Josep Moron Peret: Mòbil,Torró,Ordinador,Joc de taula,Cadireta
Mònica Gasull Pascal: Bicicleta,Capsa de bombons,Cotxe elèctric,Biberó
Carles Montroig Margalef: Mòbil,Capsa de bombons,Sabates,Bicicleta
Queralt González Perez: Nina bebé,Ràdio
Jean Solé Juvany: Jersei,Bicicleta
Didac Moya Ricart: Joc de taula
Pepa Codina Marcet: Llibre,Escacs,Conillet rosa
Zeus Pascal Ricart: Espasa de fusta
Manel Ortiz Masvidal: Cotxe
Magda Albí March: Nina bebé,Conillet rosa
Òscar Padrosa Llesera: Llapissos,Còmic,Cadireta
Filomenu Mundó Parra: Retallable
Joan Palop Palacios: Gorro,Llapissos,Galetes,Disc de música,Cadireta
Candela Pelayo Pia: Bossa de mà
Felicitat Masmitjà Gasull: Televisor,Ulleres de sol,Guerrer amb espasa,Jersei,Bufanda
Marta Mallafré Palau: Capsa de bombons,Os de peluix,Arc i fletxes
Paco Casajuana Mínguez: Manta
Pere Lozano Matarodona: Mitxons
Rufo Marcu Just: Gorro,Bossa de mà,Nina morena,Ordinador,Jersei
Víctor Masachs Moron: Guerrer amb espasa,Manta,Mitjons,Sabates,Disc de música
Sergi Picanyol Pujol: Bossa de mà,Puzzle,Arc i fletxes,Nina morena,Calendari,Mòbil
Candela Soler Armengol: Llibre de dibuixos,Llibre,Ordinador,Sabates
Homer Jorquera Alba: Mòbil,Ulleres de sol,Tren
Gerard Agulla León: Ràdio,Cotxe elèctric,Guants,Joc de taula,Bicicleta
Pep Páramo Paret: Llibre de dibuixos,Biberó
Merce Moragues : Llibreta,Còmic,Corbata,Jersei,Ràdio
Lluis Matute Messegué: Llapissos,Nina morena
Joan Aubert Pellicer: Televisor,Capsa de bombons,Jersei,Calendari
Pitu Sabater Macrané: Puzzle,Llibreta,Sabons,Conillet rosa
Zeus Parra Llansana: Llibre,Mòbil,Guerrer amb espasa,Jersei,Colònia,Cotxe
Quim Morillo Mach: Sabates
Max Lloberes Latre: Còmic,Nina rossa
Queralt Moragues Masllorens: Corbata,Ràdio
Pep Miravet Huguet: Nina morena,Biberó
Toni Jorba Palomera: Retallable,Mocador de coll,Joc de taula,Bicicleta,Colònia,Os de peluix
Joanot Parer Monells: Nina morena,Nina rossa,Sabates
Iu Albí Picanyol: Manta,Cotxe elèctric,Còmic,Biberó
Frederic González López: Ulleres de sol
Queralt Messegué Ortega: Galetes,Cadireta
Joan Lloberes Macrané: Galetes,Nina morena,Cadireta
Joaquim Morillo Morillo: Retallable,Llibre,Puzzle,Còmic,Corbata
Frances Aubert Visent: Escacs,Rellotge,Jaqueta
Sam Vives Medrano: Nina morena
Ot Moragues : Mitjons,Arc i fletxes
Maria López Pijoan: Ulleres de sol,Os de peluix,Jersei
Ernest March Jordana: Cadireta
Met Majós Oveja: Llibre,Llibreta,Bicicleta
Òscar Montià Masdevall: Galetes
Angela Serra Jové: Colònia,Jersei,Tren
Candela Pericas Macrané: Llibre,Mocador de coll,Cowboy,Joc de taula,Arc i fletxes
Merce Mula Leal: Nina bebé,Puzzle,Corbata
Víctor Parra Llucià: Cotxe
Pere Manyé Albiol: Escacs,Llapissos,Televisor,Bossa de mà
Susanna Lozano Llabot: Bufanda,Espasa de fusta,Calendari,Conillet rosa
Quim Palomera Guimerà: Bossa de mà,Nina rossa
Alfons Visent Llofriu: Televisor,Tren,Mòbil,Guants,Bufanda,Cotxe elèctric
Víctor Matarodona Lloris: Mocador de coll,Guerrer amb espasa,Cadireta
Joan Josep Majós Mancho: Nina bebé,Còmic,Cotxe,Nina rossa,Ulleres de sol,Os de peluix
Mònica Masana Vives: Mòbil
Josep Agulla Palau: Tren
Joan Montió Paraire: Caramels,Puzzle,Conillet rosa,Ràdio
Pep Pelayo Marot: Llibre de dibuixos,Puzzle,Ràdio,Cadireta
Jesus Cardona Mayans: Mòbil,Ràdio
Max Mínguez Taberner: Còmic
Quim Jara Negre: Còmic
Ernest Guixà Monné: Casa de nines
Gerard Navajas Miravet: Mitxons,Cotxe,Os de peluix,Cadireta
Sònia Palomera Murga: Corbata,Cowboy,Mocador de coll,Sabates,Cadireta,Ordinador
Met Parra Piferrer: Bicicleta
Rufo Macrané Jara: Caramels,Capsa de bombons,Sabates,Nina morena,Torró,Ordinador
Candela Pinyas Boix: Corbata,Os de peluix,Cowboy
Joanot Matute Páramo: Disc de música,Mitxons,Corbata,Cadireta
Sònia Oveja Roure: Cotxe elèctric
Mònica Soler Mans: Cotxe elèctric,Biberó
Òscar Viu Oliveras: Disc de música
Pepa Matamala Jorba: Sabates,Cowboy
Fe Taberner Morillo: Jersei
Pol Sonet Marcos: Llibre,Nina morena,Calendari,Tren
Cristian Lluch Viu: Llapissos,Manta,Mitjons,Espasa de fusta,Arc i fletxes,Llibreta
Pol Sonet Negre: Televisor
Baldiri Murga Marot: Conillet rosa
Gerard Gasull Alcoberro: Corbata,Tren,Guerrer amb espasa,Nina bebé,Còmic,Bufanda
Joan Josep Aubert Pijoan: Llibre,Caramels,Guerrer amb espasa,Jaqueta
Queralt Marcó Gual: Nina morena,Cotxe,Tren
Frances Alba Marlés: Puzzle,Mitxons,Llibreta
Enric Ordeig Messegué: Galetes,Torró,Capsa de bombons,Cowboy
Frederic Malé Julià: Caramels,Capsa de bombons,Ordinador,Calendari
Toni Masclans Peret: Retallable,Colònia,Còmic,Disc de música,Mitjons
Maria Manzano Llorente: Galetes,Manta,Ràdio
Aina Maurell Rey: Bufanda,Sabates,Calendari,Joc de taula
Xavier Pesarrodona Ortiz: Bossa de mà,Capsa de bombons,Ràdio
Didac Guardiola Masclans: Puzzle,Llibreta,Mitjons,Espasa de fusta,Cowboy
Marta Guardiola Maluquer: Escacs,Puzzle,Torró,Tren
Maria Pitarch Iglesias: Sabates
Toni Molas Palacios: Torró,Mocador de coll,Capsa de bombons
Enric Martell Paladell: Escacs,Capsa de bombons,Còmic,Llibreta
Jou Pujol León: Llibreta,Còmic,Jaqueta,Estoig,Calendari
Met Piqueras Macià: Bicicleta
Pol Lacalle Visent: Sabons,Manta,Tren,Ràdio,Còmic,Escacs
Baldiri Morral Albí: Rellotge,Cadireta
Daniel Llesera Vives: Torró,Llapissos,Sabons,Llibreta,Nina rossa
Angela Pellicer Ubach: Gorro,Os de peluix,Nina rossa
Diego Marti Montroig: Caramels,Ràdio,Corbata,Calendari,Estoig
Joan Pedreño : Jaqueta,Cowboy,Espasa de fusta,Còmic,Nina rossa,Bufanda
Marta Llucià Ingla: Bicicleta,Jaqueta,Casa de nines
Gerard Mont Marti: Bossa de mà,Guerrer amb espasa
Òscar Maurell Pallarol: Guants
Paco Junyent Marqués: Bossa de mà,Sabons,Nina morena,Estoig,Mòbil
Ot Maldonado Páramo: Galetes,Escacs,Estoig
Didac Masdevall Guasch: Bufanda,Mitxons,Jaqueta,Cotxe elèctric,Tren
Homer Mínguez Juvany: Mocador de coll,Joc de taula,Jersei,Estoig
Susanna Manzano Lluch: Retallable,Colònia,Cotxe elèctric,Os de peluix,Casa de nines
Fe Páramo Margalef: Llapissos,Guerrer amb espasa,Casa de nines
Jesus Morral Marcet: Llapissos
Joan Josep Pou Jové: Llibre,Mòbil,Disc de música,Os de peluix,Ordinador
Jesus Pinot Linares: Cowboy
Angela Ortiz Llorens: Cowboy,Guerrer amb espasa,Nina morena,Gorro,Còmic,Disc de música
Bernarda Páramo Lloris: Torró,Còmic,Biberó
Cristian Navajas Moron: Bufanda,Llibreta
Baldiri Lladó Pitarch: Llapissos,Mitxons,Mitjons,Estoig
Jou Bru Rodríguez: Llibreta,Cotxe,Calendari,Bicicleta
Joan Pelegrí Leal: Capsa de bombons
Susanna Marcó Masvidal: Llibre de dibuixos,Llapissos,Bossa de mà,Gorro,Cadireta
Miquel Ordeig Marot: Televisor,Ulleres de sol,Manta,Ordinador,Sabates
Queralt Rodríguez Marsà: Mitjons,Jersei,Tren
Carles Llauradó Matute: Guerrer amb espasa
Charly Malla Ibarra: Bossa de mà
Enric Morral Marot: Mòbil,Colònia,Llibreta,Ordinador,Sabons
Didac Not Majós: Espasa de fusta,Bicicleta,Nina morena,Conillet rosa,Cadireta,Gorro
David Montió Mínguez: Puzzle,Sabates,Nina morena,Nina rossa,Arc i fletxes,Escacs
Pitu Jorquera Pedrol: Bufanda,Torró,Nina morena
Jesus Pitarch Moron: Espasa de fusta,Calendari
Homer Nogué Puig: Mocador de coll,Nina morena
Alfons Paradís Montià: Manta,Tren,Guerrer amb espasa,Joc de taula,Galetes,Llibreta
Helena Huguet Jornet: Llapissos,Mocador de coll,Mitjons,Nina bebé,Cadireta,Disc de música
Zeus Marti Pont: Escacs,Puzzle,Còmic,Ordinador,Sabates
Pere Mercadal Pont: Sabons,Ordinador,Cowboy
Antonia Bonaterra Just: Llibre de dibuixos,Gorro,Llapissos
Sònia Pascal Pelegrí: Escacs
Enric Perez Montió: Guerrer amb espasa
Josep Antoni Llort Petit: Llibre de dibuixos,Guerrer amb espasa,Torró,Jersei
Quim Miravet Montió: Retallable,Llapissos,Nina bebé,Ulleres de sol
Frances Julià Oliveras: Bufanda,Manta,Nina morena,Guants,Cotxe
Helena Llesera Martell: Llibreta,Os de peluix,Espasa de fusta,Estoig
Josep Marlés Pedreño: Televisor,Biberó,Corbata,Mocador de coll,Mitxons,Os de peluix
Joan Josep Vives Pelegrí: Retallable,Manta,Jaqueta,Cadireta
Josep Jaques Llucià: Rellotge,Corbata,Guerrer amb espasa,Conillet rosa,Arc i fletxes,Gorro
Ot Picanyol Pont: Retallable
Sònia Maymó Llenas: Televisor,Bossa de mà,Mitxons,Estoig
Gerard Pi Mallafré: Bufanda,Capsa de bombons,Còmic,Arc i fletxes
Met Jorba Llort: Televisor,Llibre de dibuixos,Rellotge,Bossa de mà
Lluis Jordana Codina: Puzzle
Frances Pelegrí Palau: Torró
Cesc  Piferrer: Bufanda,Sabons,Llibreta,Estoig
Iu Guasch Pellicer: Sabons,Llibreta,Corbata
Carles Not Pitarch: Os de peluix
Pere Isanta Pont: Mitxons,Mitjons,Jersei,Ulleres de sol,Capsa de bombons,Cotxe
Sònia Llorens Giménez: Sabons,Corbata,Mòbil,Sabates,Nina morena,Jersei
Pol Manzano Petit: Os de peluix
Bernat Alemany Montràs: Retallable,Llapissos,Llibre,Jersei
Maria Sabater Medrano: Televisor,Gorro,Mitxons,Nina rossa
Pol Marlés Marot: Llibre,Sabates
Miquel Mascarell Mercadal: Mocador de coll,Biberó,Disc de música,Cadireta
Sònia Marot Tió: Llibre de dibuixos,Bicicleta
Sam Pinot Orobitg: Llapissos,Cotxe
Susanna Pellicer Taberner: Galetes,Jaqueta,Puzzle,Manta,Tren
Merce Gutierrez Pericas: Ulleres de sol
Quim Jornet Latre: Llibre,Caramels,Cotxe
Cristian Ingla Llucià: Galetes,Puzzle,Còmic,Ordinador,Tren
Zeus Llansana Isanta: Sabons,Casa de nines,Puzzle,Guerrer amb espasa,Arc i fletxes,Os de peluix
David Morral Lara: Escacs,Bufanda,Casa de nines
Alfons Pelayo Mata: Cotxe,Nina rossa,Tren
Frances Isern Marsà: Llibre,Cotxe elèctric,Corbata,Ràdio
Jean Albí Llort: Capsa de bombons,Nina morena
Maria Padrosa : Televisor,Torró
Diego Guardiola Marqués: Llibreta,Manta,Disc de música,Tren,Casa de nines
Pepa Juncosa Oliva: Torró,Mitxons,Caramels,Llibreta,Retallable
Òscar Oliva Marti: Mòbil,Nina morena,Espasa de fusta
Joan Perez Llort: Llibreta,Ulleres de sol,Biberó,Conillet rosa
Frederic Piñol Medina: Manta,Guerrer amb espasa,Guants,Ordinador,Sabates
Filomenu Piferrer Paraire: Galetes,Llapissos,Cotxe elèctric
Ot Palomera Ortiz: Guants,Jersei,Ràdio
Alfons Mitjavila Mata: Bufanda,Disc de música
Òscar Puig Pelegrí: Galetes,Mocador de coll,Mitxons,Corbata,Ordinador
David Masvidal Llort: Mocador de coll,Llapissos,Jaqueta,Cowboy
Bernat Mayné Llauradó: Ràdio,Llibreta,Arc i fletxes
Mireia Llach Marcu: Llibre,Llapissos,Torró,Jaqueta,Corbata
Max Guevara Ordeig: Conillet rosa
Víctor Marot Montràs: Ulleres de sol,Caramels,Manta,Os de peluix,Cadireta
Cesc Lloris Just: Retallable,Sabons,Torró,Mitjons
Merce Mínguez Pinot: Escacs,Bossa de mà,Manta,Cadireta
Víctor Luque Guardiola: Galetes,Sabons,Arc i fletxes
Jou March Hom: Mòbil
Anna Lladó Masachs: Llapissos,Cotxe,Cowboy
Cristian Marti Terrats: Ulleres de sol,Nina morena,Calendari,Nina rossa,Mocador de coll
Didac Majós Albiol: Capsa de bombons,Mitjons,Nina rossa
Queralt Monné Peret: Sabons,Rellotge,Sabates,Ràdio
Max Marcó Guvern: Televisor,Caramels,Cowboy,Joc de taula,Sabates,Cadireta
Joan Ricart Masclans: Llapissos,Bicicleta
Lluis Mancho Bru: Llibre,Mocador de coll,Joc de taula,Estoig,Jersei
Anna Marcu Alba: Mocador de coll,Cotxe elèctric,Còmic,Cowboy
Sam Cardona Serra: Galetes,Ulleres de sol,Casa de nines,Nina bebé
Maria Lluisa Manent Parra: Gorro,Torró,Conillet rosa,Disc de música,Os de peluix
Alfons Maymó Cardona: Mòbil
Sònia Piñol Marcó: Retallable,Gorro,Arc i fletxes
Joanot Messegué Paraire: Llibre de dibuixos,Nina bebé,Caramels,Llibreta
Rufo Paret Martell: Corbata,Gorro,Nina rossa,Escacs,Ulleres de sol,Llibreta
Pol Molas Juncosa: Ulleres de sol,Puzzle,Guants,Bicicleta
Merce Miravet Ordeig: Bossa de mà,Manta,Ordinador,Arc i fletxes
Pere Rodríguez Llanet: Corbata,Llibre de dibuixos,Mocador de coll,Ràdio,Retallable,Cadireta
Mireia Malla Pinot: Ràdio
Mònica Palomera Masdefiol: Ulleres de sol,Caramels,Conillet rosa,Jersei,Arc i fletxes
Xavier Palomera Palacios: Mocador de coll,Guerrer amb espasa,Conillet rosa,Sabates
Sergi Matute Maginet: Llibre de dibuixos
Pep Brau Hom: Galetes,Ulleres de sol,Caramels,Mitxons,Ordinador
Jou Ortiz Sonet: Biberó,Cotxe elèctric,Jaqueta,Espasa de fusta,Casa de nines
Maria Lluisa Masmitjà Monells: Llapissos,Torró,Mòbil
Xavier Martell Giménez: Nina morena
Maria Lluisa Marcu Jara: Mòbil
Maria Lluisa Gual Gasull: Sabons,Jaqueta,Jersei
Jou Macrané Iglesias: Capsa de bombons
Anna Manent Armengol: Mòbil,Guerrer amb espasa,Ràdio
Josep Antoni Macrané Guevara: Mocador de coll,Biberó,Calendari,Cowboy
Josep Mach Palau: Torró,Llibreta,Cadireta
Magda Marcos Pey: Biberó,Mocador de coll,Cadireta,Guants,Jersei,Arc i fletxes
Joan Albí Mercadal: Nina bebé,Mitjons,Calendari,Bicicleta
Pol Mayné Jové: Bufanda
Jou Gual Albiol: Mitxons,Tren
Queralt Tubau Llesera: Llibre de dibuixos,Torró,Manta,Ràdio
Sergi Gasull Marcos: Capsa de bombons
Josep Antoni Llauradó Picanyol: Llibre,Cowboy,Estoig,Joc de taula,Espasa de fusta,Llibreta
Met Macià Pedrol: Televisor,Corbata,Mitxons,Ràdio,Nina rossa,Colònia
Alfred Moragues Paladell: Galetes,Còmic,Guants,Ordinador
Toni Pallarol Jordana: Caramels,Conillet rosa,Ràdio
Charly Piñol Mata: Mitxons
Angela Puig Llenas: Llibre,Escacs,Caramels,Guerrer amb espasa,Sabates
Cesc Llucià Molas: Colònia,Joc de taula,Cotxe,Arc i fletxes
Òscar Munné Palop: Llibreta,Os de peluix
Queralt Pitarch González: Torró,Mitxons,Bicicleta
Xavier Masana Llansana: Televisor,Mitxons,Jersei,Sabates,Espasa de fusta,Torró
Angela Monells Ortiz: Os de peluix
Queralt Margalef Jodar: Llibre de dibuixos,Cotxe elèctric,Còmic,Arc i fletxes
Candela Maginet Guardiola: Joc de taula
Miquel Leal Manzano: Mitxons,Puzzle,Nina morena,Rellotge,Espasa de fusta
Carles Platja Matamala: Mitjons
Josep Just Jodar: Mocador de coll,Os de peluix
Daniel Perez Macrané: Mòbil,Cotxe elèctric,Espasa de fusta,Llibreta
Magda Llach Llatser: Estoig
Paco Guardiola Ortiz: Llibre,Llibre de dibuixos,Biberó,Nina morena,Conillet rosa
Josep Matute Jara: Llibre de dibuixos
Jesus Ingla Guevara: Cadireta,Sabates,Arc i fletxes
Pepa Martell Paradís: Escacs,Cotxe elèctric
Bernat Montià Serra: Gorro,Sabates,Espasa de fusta,Bicicleta
Miquel Molas Matute: Colònia,Jaqueta,Ordinador,Cowboy
Queralt Hom Moragues: Gorro,Torró,Sabates,Casa de nines
Ot Mercadal Munné: Mitjons
Queralt Solé Vilamoll: Caramels,Os de peluix
Marti Pascal Martell: Llibre,Capsa de bombons,Casa de nines
Baldiri Montià Ruiz: Caramels,Jersei
Frederic Cardona Vives: Capsa de bombons,Guants
David López Lozano: Ulleres de sol
Queralt Guimerà Moya: Escacs,Llibreta
Merce Junyent Pou: Nina morena,Conillet rosa,Sabates
Homer Picanyol Palacios: Retallable,Televisor,Escacs,Calendari,Casa de nines
Iu Pedrol Maldonado: Puzzle,Llibreta
Quim Medrano Montià: Mòbil,Puzzle,Nina morena,Ordinador,Nina rossa
Marti Marín Mínguez: Mitjons
Enric Padrosa Marlés: Nina bebé,Guerrer amb espasa,Colònia,Manta,Ràdio
Cristian Pelegrí Llansana: Bossa de mà,Cowboy
Jesus Ibarra Majós: Bufanda,Torró,Tren
David Morral Pallarol: Mocador de coll,Sabates
Mireia Iranzo Alemany: Mitjons
Frederic Llobet Lladó: Gorro,Nina bebé,Nina morena,Conillet rosa
Max Mascarell Juanola: Guerrer amb espasa,Corbata,Sabates
David Codina Serra: Gorro,Cadireta,Còmic,Arc i fletxes
Ot Pujol Medrano: Llapissos,Llibreta,Calendari,Jersei,Ràdio
Pol Ortega Rodríguez: Televisor,Rellotge,Torró,Sabates
Ernest Manent Masana: Biberó,Mocador de coll,Mitjons,Sabates,Arc i fletxes,Disc de música
Rufo Oliveras Llabot: Televisor,Mòbil,Còmic,Arc i fletxes,Cadireta
Didac Puig Gual: Llibre de dibuixos,Galetes,Escacs,Ràdio
Fe Alcoberro Majós: Sabons,Nina morena,Corbata,Cowboy
Maria Pedrol Solé: Llapissos,Capsa de bombons,Tren,Ulleres de sol
Víctor Maruny Piñol: Televisor,Tren,Mocador de coll,Guerrer amb espasa,Gorro,Capsa de bombons
Òscar Pascal Llanet: Colònia,Conillet rosa
Joanot Giménez Pinot: Caramels
Met Alemany Laborda: Jaqueta,Tren,Mitjons,Bicicleta,Cotxe elèctric,Ordinador
Mònica Medina Mont: Còmic
Víctor Montió Morillo: Llibre de dibuixos,Rellotge,Cadireta,Jaqueta,Cowboy
Didac Pinot Ibarra: Puzzle,Llibreta,Nina morena,Conillet rosa,Tren
Maria Sabater Picanyol: Televisor,Bicicleta,Nina morena,Arc i fletxes,Gorro,Llibreta
Marta Lara Mula: Bufanda,Sabons,Guerrer amb espasa,Jaqueta,Corbata
Felicitat Lacalle Parer: Torró,Cotxe elèctric
Maria Lluisa Marcó Padrosa: Llapissos,Sabons,Corbata,Sabates,Calendari,Galetes
Queralt  Codina: Corbata,Tren,Guants,Espasa de fusta,Arc i fletxes,Bufanda
Mònica Juanola Hosta: Llibreta,Nina rossa
Toni Ruiz Peret: Cadireta
Pep Paraire Oliva: Retallable,Televisor,Còmic,Ràdio
Paco Jové Masdefiol: Colònia,Corbata,Guerrer amb espasa,Arc i fletxes,Cadireta,Capsa de bombons
Frederic Monells Pou: Nina bebé,Biberó,Cowboy
Maria Paraire Jorquera: Capsa de bombons
Susanna Pascal Llenas: Disc de música,Cowboy
Miquel Magrinyà Manzano: Sabates,Os de peluix,Cotxe
Toni Juvany Not: Escacs,Sabates
Met Jaques Lacalle: Televisor,Cowboy,Guants,Jersei,Nina morena,Colònia
Pitu Mínguez Pelayo: Gorro,Joc de taula,Espasa de fusta
Diego Jara Codina: Llibre,Caramels,Mocador de coll,Jersei,Bicicleta,Capsa de bombons
Joaquim Hosta Soler: Bicicleta,Conillet rosa,Arc i fletxes
Didac Lloberes Pastoret: Bossa de mà,Cadireta
Diego Masachs Jodar: Llibre,Rellotge,Capsa de bombons,Cowboy
Didac Monells Guvern: Bossa de mà,Guerrer amb espasa,Jaqueta,Cotxe
Maria Lluisa Vilamoll Bonaterra: Nina bebé,Mitjons,Sabates,Ràdio
Cesc Oveja Vilamoll: Llibre de dibuixos,Escacs,Sabons,Corbata,Espasa de fusta
Sam Oliva Masdefiol: Televisor,Mitxons
Joanot Mercadal Llatser: Galetes,Biberó,Espasa de fusta,Joc de taula
Alfred Montià Pijoan: Biberó,Cowboy,Conillet rosa,Escacs,Cotxe elèctric,Os de peluix
Angela Macrané Piferrer: Rellotge,Corbata,Retallable,Puzzle,Joc de taula,Arc i fletxes
Pitu Guirao Huguet: Sabates
Pepa Parer Guirao: Llibre de dibuixos,Ràdio
Enric Aubert Aubert: Bufanda,Galetes,Còmic,Cotxe elèctric
Gerard Mont Ibarra: Ràdio
Toni Mans Pascal: Bossa de mà,Arc i fletxes
Aina Mach Pastoret: Capsa de bombons,Mitxons,Còmic,Manta,Llibreta
Josep Isanta Munné: Llibreta,Mitjons
Queralt Pijoan Molas: Llibre,Espasa de fusta,Casa de nines
Lluis Masana Olivella: Mitxons,Calendari
Cristian Ruiz Matute: Retallable,Mocador de coll,Colònia,Conillet rosa
Filomenu Pinyas Mercadé: Colònia,Corbata
Pep Jové Oveja: Galetes,Llibreta,Jaqueta
Aina León Margalef: Bossa de mà,Manta,Mitjons,Calendari
Sònia Manyé Lloris: Mitxons,Guerrer amb espasa,Nina morena
Charly Llenas Murga: Cotxe,Disc de música,Nina rossa
Joanot Llobet Giménez: Torró,Calendari
Enric Pujol Manzano: Calendari,Sabates
Frances Aubert Páramo: Galetes,Disc de música,Mitjons
Toni Munné Alemany: Jersei
Josep Antoni Brunyol Ruiz: Llapissos,Rellotge,Cotxe elèctric,Cowboy
Joan Josep Llesera Boix: Llibreta,Jersei
Ot Pijoan Julià: Mòbil,Llibreta,Espasa de fusta,Os de peluix
Pere Piferrer Padilla: Biberó,Bossa de mà,Bicicleta,Nina rossa,Tren
Xavier León Messegué: Mocador de coll,Llibreta,Manta,Os de peluix,Bicicleta
Cristian Magrinyà Bonastre: Mitxons,Puzzle,Colònia,Ulleres de sol
Jean Jaques Jornet: Llapissos,Rellotge,Joc de taula,Sabates,Conillet rosa,Bufanda
Pol Jordana Lloberes: Mitxons
Felicitat Piferrer Maymó: Mitjons
Helena Jordana Petrus: Televisor,Sabates,Jersei,Conillet rosa,Ràdio
Paco Pedrol Petrus: Bossa de mà,Guants,Espasa de fusta,Ràdio,Cadireta,Ordinador
Didac Matute Marcu: Sabons,Cowboy,Casa de nines,Cadireta,Ordinador,Tren
Magda Lluch Mundó: Casa de nines
Sònia Casajuana Oliveras: Retallable,Rellotge,Caramels,Casa de nines
Joanot Vinals Leal: Jaqueta,Nina rossa
Homer Brunyol Laborda: Bufanda,Colònia,Manta,Mitjons,Espasa de fusta
Joanot Malé Agulla: Caramels,Biberó,Espasa de fusta,Bicicleta
Víctor  Isern: Retallable,Torró,Mitxons,Mitjons,Llapissos
Alfons Paraire Platja: Llibre,Llapissos,Sabates
Joan Mancho Tubau: Llibreta,Estoig,Cadireta
Homer Lara Rodríguez: Rellotge,Nina rossa,Cowboy
Lluis Padrosa Moragues: Bossa de mà,Guants,Sabates,Bicicleta
Manel Soler Ruiz: Retallable,Mòbil,Guants,Còmic,Calendari,Colònia
Helena Juncosa Tió: Os de peluix,Arc i fletxes
Fe Juanola Llansana: Nina rossa,Tren
Ot Malla Pastoret: Manta,Guants,Mitjons,Sabates,Escacs,Torró
Homer Leal Pont: Guerrer amb espasa,Còmic,Corbata,Sabates,Disc de música
Antonia Jorba Llanet: Gorro,Bufanda,Casa de nines,Sabates,Bicicleta
Miquel Luque Ubach: Colònia,Sabates,Ràdio
Met Ortiz Oveja: Colònia,Guants,Corbata
Joan Josep Gasull Pijoan: Guants,Mitxons,Jersei,Cotxe elèctric,Espasa de fusta
Bernarda Just Majós: Llibre
Víctor Brau Matute: Llibre de dibuixos,Torró,Ordinador
Diego Murga Iranzo: Televisor,Guants,Sabates
Ot Jorba Mayans: Mitjons,Sabates
Didac Jara Monells: Gorro,Llibreta,Jaqueta,Cotxe elèctric,Espasa de fusta
Joanot Llauradó Moron: Llapissos,Torró,Bicicleta
Jou Masllorens Páramo: Ulleres de sol,Puzzle,Manta,Mòbil
Marta Brunyol Juncosa: Rellotge,Torró,Ordinador,Sabates
Daniel Páramo Iglesias: Bossa de mà,Llibreta,Manta
Sam Pelayo Palomera: Còmic,Estoig
Paco Montió Marti: Llapissos
Víctor Pey Ordeig: Mitxons,Colònia,Llibreta,Sabates,Casa de nines
Lluis Pou Pinyas: Conillet rosa
Merce Murga Munné: Joc de taula
Anna Ruiz Brunyol: Llibre de dibuixos,Colònia,Guants,Mitjons,Estoig
Cesc Guilella Palomera: Llibre de dibuixos,Guerrer amb espasa,Conillet rosa
Gerard Mula Pia: Llibre de dibuixos,Bossa de mà,Mitjons,Cotxe,Ordinador
Homer Tubau Masolivé: Cotxe elèctric,Mòbil,Espasa de fusta,Nina morena,Nina rossa,Torró
Iu León Sonet: Bufanda,Bossa de mà,Còmic,Sabates
Maria Rodríguez Latre: Manta,Sabates
Pep  Llorens: Rellotge,Jaqueta,Tren,Espasa de fusta,Conillet rosa,Capsa de bombons
David Manent Terrats: Puzzle,Colònia,Manta,Rellotge,Ràdio
Paco Huguet Marata: Torró
Antonia Raga Masvidal: Caramels,Puzzle,Estoig,Ràdio,Disc de música,Os de peluix
Paco Llanet Moya: Arc i fletxes,Rellotge,Llibreta,Estoig,Cadireta
Rufo Not Monells: Llibreta,Casa de nines
Carles Maluquer Miravet: Retallable,Corbata
Pep Puig Medrano: Ulleres de sol,Mòbil,Estoig,Espasa de fusta,Bicicleta
Susanna Pairó Hom: Jaqueta,Bicicleta,Nina bebé,Calendari,Ulleres de sol,Ordinador
Iu Masdevall Lladó: Retallable
Sam Mundó Marqués: Ulleres de sol,Cotxe elèctric,Cadireta,Llibreta,Biberó
Candela Mancho Molas: Televisor,Bossa de mà,Biberó,Nina rossa,Ulleres de sol
Helena Jové Mach: Gorro,Jersei,Conillet rosa,Ràdio
Marta Pey Brau: Colònia,Manta,Estoig,Ràdio,Cadireta,Capsa de bombons
Pepa Brau Lladó: Bufanda,Mocador de coll,Corbata
Sergi Petrus Gutierrez: Biberó
Homer Parer Magrinyà: Televisor,Cotxe,Torró,Mitjons,Nina rossa
Pep Petit Malla: Nina bebé
Maria Lluisa Morral Petit: Biberó,Llapissos,Llibreta,Ordinador,Cowboy
Fe Albiol Jordana: Televisor,Caramels,Biberó,Cowboy,Jersei,Cotxe
Merce Llabot Masdefiol: Cotxe elèctric
Maria Lluisa Majós Llobet: Rellotge
Sam Marsà Alemany: Jaqueta,Nina rossa,Cotxe
Antonia Montió Serra: Gorro,Guerrer amb espasa
Lluis Marqués Agulla: Televisor,Llapissos,Jaqueta,Calendari,Capsa de bombons,Ordinador
Sònia Jaques Marsany: Llapissos,Mitxons,Sabates,Cotxe elèctric
Josep Montió Ruiz: Llibre,Disc de música,Tren
Sònia Llorens Marti: Os de peluix
Cesc Matarodona Palop: Sabates,Conillet rosa,Bicicleta
Xavier Latre Llucià: Llibre,Sabons,Torró,Ordinador,Nina rossa
Zeus Malé Icart: Caramels,Guants,Estoig,Sabates
Didac Maldonado Brunyol: Escacs,Gorro,Colònia,Cotxe elèctric,Cowboy
Toni Pellicer Llobet: Galetes,Gorro,Caramels,Mitjons
Alfred Majós Olivella: Colònia,Estoig,Joc de taula,Ràdio
Queralt Moya Gasull: Guerrer amb espasa,Nina morena,Os de peluix
Pere Casajuana Masmitjà: Llibreta
Carles Masllorens Macià: Llibreta,Sabates
Jesus Llenas Llofriu: Nina morena
Candela Nogué Alba: Escacs,Galetes,Rellotge,Còmic,Bicicleta
Joan Serra Parer: Retallable
Toni Armengol Sabater: Rellotge,Manta,Tren,Mòbil,Escacs,Torró
Daniel Monells Petit: Llibre de dibuixos,Guerrer amb espasa,Manta
Frances Brunyol Perez: Llibre
Daniel Paula Macrané: Retallable,Casa de nines
Manel Ortega Marata: Guants
Queralt Giménez Marín: Sabates
Aina Mata Ortega: Bossa de mà,Mitxons,Sabates,Os de peluix
Sònia Pia Llorens: Gorro,Biberó,Llibreta
Joanot Guasch Moya: Televisor,Escacs,Nina morena,Ordinador,Cowboy
Pep Iranzo Pijoan: Llibre de dibuixos,Mocador de coll,Cowboy,Calendari,Cadireta
Alfred Huguet Lloberes: Capsa de bombons,Biberó,Nina rossa,Llibreta
Marta Viu Llabot: Rellotge,Biberó,Corbata,Guants,Nina rossa,Capsa de bombons
Sònia Margalef Marata: Bufanda,Nina morena,Arc i fletxes
Ot Marcu Mayans: Bossa de mà,Guerrer amb espasa
Marti Ortega Alemany: Cotxe elèctric,Nina rossa,Arc i fletxes
Enric Llort Jorquera: Rellotge,Puzzle,Ordinador,Sabates,Mocador de coll
Frances Guevara Magrinyà: Llapissos,Corbata,Cowboy,Guerrer amb espasa,Guants,Nina bebé
Carles Juncosa Icart: Colònia,Corbata,Guerrer amb espasa,Nina morena,Nina rossa,Torró
Bernat Majós Llesera: Corbata,Joc de taula
Met Jordana Juvany: Rellotge,Guerrer amb espasa,Manta,Cowboy
Susanna Llofriu Manent: Bufanda,Llibre de dibuixos,Escacs
Joaquim Juvany Ruiz: Mòbil,Jersei
Sam Gasull Lacalle: Gorro,Os de peluix,Conillet rosa
Queralt Ricart Ordeig: Llibreta
Joanot Mont Moya: Retallable,Bossa de mà,Televisor,Escacs,Llibre de dibuixos
Angela Paula Llabot: Manta,Ordinador,Calendari,Cadireta
Quim Guirao Llabot: Bufanda
Homer Moron Montràs: Caramels,Cotxe elèctric,Espasa de fusta,Conillet rosa
Paco Mascarell Laborda: Llibre,Manta,Mitjons
Met Petit Mach: Llibre,Llapissos,Rellotge,Mocador de coll,Joc de taula,Ràdio
Sergi Juvany Masachs: Puzzle,Mitxons,Guants,Jersei,Tren
Merce Masclans Ruiz: Mocador de coll,Casa de nines,Tren,Bicicleta
Cristian Pinyas Isern: Joc de taula
Merce Soler Ubach: Ulleres de sol,Rellotge,Ordinador
Josep Brunyol Mascarell: Jaqueta,Sabates
Pepa Guardiola Masachs: Gorro,Caramels,Llibreta,Còmic
Miquel Guasch Morral: Capsa de bombons
Met Mach Manent: Llibreta
Cesc Masana Pou: Bufanda,Nina bebé
Candela Marín Nogué: Biberó,Mòbil,Nina bebé,Nina rossa,Mocador de coll,Torró
Charly Lozano Lloris: Gorro,Rellotge,Mitxons,Guants,Tren
Baldiri March Guvern: Galetes,Tren,Còmic,Llibreta,Ràdio
Bernarda Marata Jodar: Llibreta,Ràdio,Còmic,Gorro,Torró,Ordinador
Mireia Monells Nogué: Llibre,Joc de taula,Nina rossa,Cotxe,Bicicleta
Pere Sabater Llach: Rellotge,Biberó
Baldiri Montió Parer: Bossa de mà,Cotxe elèctric,Calendari,Bicicleta
Lluis Mula Maginet: Gorro,Caramels,Llibreta,Estoig,Sabates
Queralt Llanet Icart: Mitxons,Capsa de bombons,Jaqueta,Estoig
Angela Codina Murga: Espasa de fusta,Corbata,Nina rossa,Cadireta
Toni Macrané Pi: Jaqueta,Colònia,Llibreta,Còmic,Conillet rosa
Helena Gual Juanola: Llapissos,Llibreta,Jaqueta,Jersei
Quim Vinals Pallejà: Gorro
Queralt Lladó Llansana: Caramels,Arc i fletxes,Corbata,Bicicleta
Joaquim Marsany Marín: Llibreta,Torró,Espasa de fusta
Candela Mascarell Ingla: Espasa de fusta
Bernarda Pujol Laborda: Bufanda
Pol Oliva Jorquera: Escacs,Galetes,Còmic,Joc de taula,Bufanda
Sergi Masdevall Malé: Puzzle,Nina rossa,Cotxe
Bernarda Llach Medrano: Mocador de coll,Biberó,Còmic,Llibreta
Felicitat Montià Masvidal: Llibre
Sam Guasch Moragues: Torró,Conillet rosa,Calendari
David Lloberes Jordana: Mocador de coll,Jaqueta,Corbata,Conillet rosa
Daniel Montràs Maginet: Llibre,Biberó,Calendari,Jersei,Bicicleta
Marti Alcoberro López: Televisor,Guants,Jersei,Casa de nines
Fe Marcó Masana: Caramels,Tren,Sabons,Espasa de fusta,Nina morena,Llibreta
Lluis Icart Lladó: Bossa de mà,Cotxe elèctric,Cotxe,Cowboy
Jou Picanyol Casajuana: Gorro,Capsa de bombons,Sabates
Josep Lozano Margalef: Mitxons,Manta,Sabates
Joan Josep Manzano Casajuana: Bossa de mà,Arc i fletxes
Marti Llach March: Caramels,Colònia,Espasa de fusta,Arc i fletxes
Joaquim Pinot Laborda: Llibre de dibuixos,Bicicleta,Cotxe elèctric,Còmic,Biberó
Rufo Paula Majós: Estoig
Iu Padrosa Guimerà: Cowboy,Còmic,Sabates,Cadireta
Candela Palacios Masdevall: Bossa de mà,Puzzle,Guants,Mòbil,Torró,Ordinador
Frederic Mayné Pey: Puzzle,Guerrer amb espasa,Os de peluix,Llibreta
Candela Pascal Páramo: Capsa de bombons,Rellotge,Cotxe elèctric,Manta,Cowboy
Enric Huguet Isanta: Torró,Cotxe elèctric,Calendari
Max Vives Ubach: Mòbil,Nina morena,Manta,Llibreta,Cadireta
Homer Maurell Munné: Televisor,Llibreta,Mitjons,Espasa de fusta,Torró,Os de peluix
Ernest Llabot Aubert: Os de peluix,Cadireta
Fe Lara Nogué: Llibreta,Joc de taula
Anna Medina Visent: Biberó
Joanot Llorens Gasull: Galetes,Nina bebé,Guants,Conillet rosa
Pol Brunyol Fernàndez: Llibreta,Manta,Corbata,Ràdio
Fe Serra Montió: Llibre de dibuixos,Mitxons,Espasa de fusta
Òscar Matute Monné: Mocador de coll,Sabons,Rellotge,Cotxe
Maria Lluisa Mans Tubau: Llibre,Mitjons
David Serra Ortiz: Llapissos
Joanot Paula Guvern: Galetes,Mocador de coll,Mitjons,Sabates
Pere Maurell Visent: Caramels,Llibre de dibuixos,Bossa de mà,Jersei,Llibreta,Cotxe
Queralt Palomera Morral: Bufanda,Guants
Joan Josep Maymó Petrus: Mòbil,Caramels,Llibreta,Casa de nines
Pep Guvern Vinals: Sabates,Capsa de bombons,Disc de música,Os de peluix
Helena Macrané Miravet: Jersei,Tren
Didac Isanta Julià: Sabons
Angela Macrané Maldonado: Biberó
Ernest Marata Gutierrez: Sabates,Conillet rosa,Ràdio
Susanna Soler Majós: Sabates,Capsa de bombons,Joc de taula,Jersei
Jesus Picanyol Ingla: Llibre de dibuixos,Puzzle,Cotxe
Jou Giménez Guilella: Colònia,Sabates
Òscar Jodar Aubert: Nina bebé,Ràdio
Llibre,Llapissos,Rellotge,Cowboy,Llibre de dibuixos,Ràdio,Calendari,Bufanda,Bicicleta,Ordinador
