Joaquim Mancho Leal: Retallable,Televisor,Guerrer amb espasa,Manta
Bernat Majós Marot: Gorro,Bufanda,Puzzle,Mitxons,Bicicleta
Charly Piqueras Majós: Mòbil,Caramels,Estoig
Joaquim Pairó Pedrol: Retallable,Ulleres de sol,Puzzle,Corbata
Cesc Llanet Pericas: Mocador de coll,Cowboy,Tren,Estoig,Cadireta
Didac Orobitg Juncosa: Corbata,Cowboy
Frances Mayné Casajuana: Gorro,Ulleres de sol,Corbata,Arc i fletxes
Daniel Lladó Lloris: Llibre,Ulleres de sol,Mitjons,Conillet rosa
Didac Alba Tubau: Gorro,Cotxe elèctric
Ernest Brunyol Marsany: Colònia,Llibreta,Jersei,Cowboy
Jean Jara Jiménez: Televisor,Cotxe elèctric
Joanot Piferrer March: Rellotge,Nina rossa,Sabates
Ot Montià Juncosa: Mitjons,Conillet rosa
Max Codina Soler: Cotxe,Tren
Homer Juncosa Llansana: Televisor,Llapissos
Fe Guirao Soler: Gorro,Rellotge,Disc de música
Enric Pujol Margalef: Conillet rosa,Caramels,Corbata,Nina rossa,Puzzle
Helena Armengol Mata: Mòbil,Corbata,Cowboy
Susanna Llabot Malé: Estoig,Jaqueta,Disc de música,Ràdio
Queralt Maymó Maruny: Bossa de mà,Biberó,Joc de taula,Nina bebé
Marta Jaques Jodar: Llibre,Retallable,Caramels
Marti Marcos Piqueras: Mitxons,Cotxe elèctric,Cotxe,Nina rossa
Bernarda Ruiz Aubert: Os de peluix
Pepa Palacios Negre: Nina morena,Ràdio
Bernat Llabot Palop: Torró,Ulleres de sol,Llibreta,Mòbil,Cowboy
Queralt Palop Monné: Caramels,Manta,Cowboy,Joc de taula,Bicicleta,Arc i fletxes
Òscar Piñol Mallafré: Biberó,Os de peluix,Jersei
Joan Llansana Junyent: Televisor,Guants
David Lluch Mercadal: Mocador de coll,Torró,Conillet rosa,Jersei,Arc i fletxes
Enric Pellicer Mach: Llibre,Sabons,Joc de taula,Bicicleta
Candela Marlés Ruiz: Llapissos
Didac Just Latre: Cadireta,Colònia,Jaqueta,Estoig,Tren
Anna Lara Paradís: Rellotge,Capsa de bombons,Colònia,Casa de nines
Sònia Macrané Llucià: Mitjons,Ordinador,Cotxe,Cowboy
Helena Platja Marqués: Sabons,Mitxons,Nina rossa
Antonia Moron Viu: Nina bebé,Bossa de mà,Mitxons,Guants,Ràdio
Mònica Ubach Murga: Capsa de bombons,Nina bebé,Mitxons,Jaqueta,Cotxe elèctric
Rufo Llanet Pedrol: Gorro,Llibre,Rellotge,Tren
Alfred Llorens Llucià: Biberó,Manta,Mitjons,Llibreta
Joanot Marcos Mínguez: Nina bebé,Puzzle
Marta Masvidal Nogué: Guants,Tren,Jaqueta,Disc de música,Estoig
Joanot Hosta Piferrer: Retallable,Escacs,Biberó
Queralt Macià Ortega: Sabates
Marti Parra Mínguez: Guerrer amb espasa
Xavier Masmitjà Molas: Televisor,Bossa de mà,Colònia,Capsa de bombons,Estoig
Carles Pesarrodona Mayné: Nina bebé,Nina morena,Jaqueta,Mitjons
Max Llort Masachs: Mòbil,Torró,Mitjons,Tren
Jean Mundó Llorens: Puzzle,Estoig
Marta Ricart : Escacs,Ulleres de sol,Caramels,Ordinador
Felicitat Mercadal Morral: Cotxe elèctric,Biberó,Nina morena,Bufanda,Torró,Ordinador
Pepa Bonastre Pinot: Rellotge,Sabates,Tren
Paco Parra Matarodona: Llibre,Cotxe
Charly Parra Pitarch: Ulleres de sol,Puzzle,Cotxe elèctric,Sabates,Guerrer amb espasa
Paco Mitjavila Llanet: Ordinador,Os de peluix,Cowboy
Merce Pellicer Parer: Guerrer amb espasa
Jean Messegué Marot: Calendari,Corbata,Nina rossa,Disc de música
Marta Raga Padrosa: Bicicleta,Arc i fletxes,Bufanda,Ulleres de sol,Torró,Os de peluix
Enric Maluquer Pia: Cotxe elèctric,Bicicleta
Diego Agulla Gutierrez: Mòbil,Caramels
Víctor Jara Morillo: Rellotge,Espasa de fusta
Joan Fernàndez Alcoberro: Llibre,Mocador de coll,Retallable,Mitjons
Bernarda Páramo Masachs: Cowboy,Ràdio
Maria Páramo Terrats: Colònia,Cotxe elèctric,Casa de nines
Joan Josep Oveja Viu: Manta,Tren,Mocador de coll,Espasa de fusta,Ràdio,Disc de música
Òscar Montià Albiol: Casa de nines,Nina bebé,Nina rossa,Arc i fletxes,Galetes,Ordinador
Alfons Vinals Vives: Ràdio,Manta,Cadireta
Pere Jaques Paladell: Torró,Mitxons,Ordinador,Ràdio
Paco Pastoret Icart: Retallable,Llapissos,Tren,Nina rossa,Arc i fletxes
Homer Marcó Raga: Ràdio
Josep Majós Piqueras: Bufanda
Víctor Masana Medrano: Ulleres de sol,Caramels,Jaqueta
Mireia Marti Miravet: Televisor,Rellotge,Manta,Retallable,Puzzle,Jersei
Anna Llesera Guimerà: Colònia
Òscar  Miravet: Mòbil,Guants,Ulleres de sol,Jaqueta,Cowboy
Víctor Jara Llansana: Puzzle
Víctor Pey Visent: Os de peluix
Enric Pujol Terrats: Televisor,Torró,Bicicleta
Candela Pascal Palau: Nina bebé,Mitxons,Ordinador,Nina rossa,Ràdio
Mireia Llanet Juvany: Colònia,Nina morena
Lluis Palau Albiol: Mocador de coll,Tren
Queralt Luque Monné: Bufanda,Torró,Sabates,Arc i fletxes
Candela Leal Llort: Bufanda,Capsa de bombons,Os de peluix
Fe Jornet Vinals: Llibreta,Tren,Casa de nines
Alfons Marqués Vives: Mòbil,Guerrer amb espasa,Jaqueta,Mitjons,Bicicleta
Gerard Guilella Masachs: Gorro,Jersei,Os de peluix,Joc de taula
Angela Mancho Pou: Mocador de coll,Puzzle,Colònia,Jersei
Quim Giménez Masana: Caramels,Colònia,Disc de música,Os de peluix,Cowboy
Queralt Fernàndez Marot: Galetes,Bufanda,Cowboy,Nina rossa,Casa de nines
Jean Masclans Masachs: Llapissos,Torró,Nina rossa,Ràdio
Josep Antoni Llanet Macià: Galetes,Sabons,Nina morena,Estoig,Sabates
Aina Oliva Marlés: Ràdio,Guerrer amb espasa,Casa de nines
Alfred León Rodríguez: Llibre,Rellotge,Mitjons,Tren
Cesc Morillo Lozano: Llibre,Rellotge
Josep Pairó Albí: Llibre,Mocador de coll,Escacs,Nina rossa,Galetes,Torró
Marti Juvany Munné: Galetes,Escacs,Colònia
Jesus Agulla Leal: Televisor,Retallable
Mireia Lluch Pitarch: Bufanda,Escacs,Casa de nines,Ulleres de sol,Arc i fletxes
David Llesera Ordeig: Bossa de mà,Caramels,Corbata,Conillet rosa
Maria Lluisa Jornet Mans: Bossa de mà,Jaqueta,Cotxe,Cowboy
Josep Antoni Soler Mach: Rellotge,Sabates
Sergi Ruiz Codina: Corbata,Calendari,Ràdio
Joan Nogué Llatser: Biberó
Ot Lara Maluquer: Ràdio,Cadireta
Joan Lozano Llofriu: Llibre,Colònia,Guerrer amb espasa,Manta
Diego Matamala Llesera: Ordinador,Conillet rosa
Pol Malla Julià: Rellotge,Guants,Disc de música
Víctor Mitjavila Guvern: Sabons,Mitjons,Joc de taula,Puzzle
Didac Gasull Mercadé: Gorro,Colònia,Nina morena,Conillet rosa,Sabates
Joan Palop Moragues: Televisor,Cotxe elèctric,Jaqueta,Joc de taula,Escacs,Capsa de bombons
Bernat Molas Mercadal: Escacs,Torró
Max Marín Brunyol: Puzzle,Guants,Cotxe
Miquel Pelegrí Pedrol: Escacs,Sabates,Corbata,Cotxe,Cadireta
Manel Raga Hosta: Retallable
Jesus Ruiz Palau: Llibreta,Arc i fletxes,Guants,Casa de nines,Cowboy
Frederic Lladó Paraire: Cotxe elèctric,Disc de música
Angela Isern Morillo: Casa de nines,Ordinador,Arc i fletxes
Zeus Masclans Monells: Llibre,Retallable,Mòbil,Cadireta,Bicicleta,Bossa de mà
Bernarda Moya Marcó: Escacs,Mòbil,Conillet rosa
Paco Vilamoll Monells: Sabons
Magda Monells Páramo: Retallable,Mocador de coll,Rellotge,Conillet rosa,Tren
Magda Peret Hernández: Llibreta
Gerard Molas Pedrol: Galetes
Pitu Paula Murga: Ràdio,Guerrer amb espasa,Espasa de fusta,Cadireta
Filomenu Vilamoll Oveja: Llibreta,Guants,Cadireta
Bernarda Manyé Guimerà: Televisor
David Macià Sonet: Nina bebé,Jersei
Felicitat López Rodríguez: Televisor,Nina morena,Conillet rosa,Casa de nines
Antonia Mercadé Monné: Guerrer amb espasa,Colònia,Nina morena,Nina rossa,Ràdio
Charly Jornet Mont: Bossa de mà,Mitxons,Biberó
Daniel Llauradó Pallejà: Jaqueta,Guants,Mòbil
Daniel Mitjavila Pastoret: Llibreta,Tren,Nina rossa,Arc i fletxes
Ernest Bonastre Mayans: Bossa de mà,Colònia,Capsa de bombons
Max Pou Malla: Llibre,Nina morena,Conillet rosa
Daniel Llach Llucià: Mitjons,Cadireta,Joc de taula,Jersei,Bicicleta
Mònica Masana Latre: Televisor,Nina bebé,Guants,Estoig,Bicicleta
Gerard Pitarch Jorba: Llibre,Mocador de coll,Corbata
Didac Puig Albiol: Gorro,Caramels,Guerrer amb espasa
Sergi Monells Montràs: Llapissos,Sabons,Colònia,Jaqueta,Arc i fletxes,Cotxe elèctric
Pere Pi Manent: Nina bebé,Puzzle,Mitxons,Guants,Disc de música
Marta Moya Navajas: Rellotge,Manta,Corbata,Tren,Conillet rosa,Galetes
Antonia Albí Soler: Puzzle
Frederic Albí León: Llibreta,Manta,Corbata,Mitjons
Cristian Matamala Ortega: Ulleres de sol,Mòbil,Guants,Disc de música,Ràdio
Felicitat  Latre: Bossa de mà,Llapissos,Puzzle,Sabates,Casa de nines
Ot Alba Isanta: Galetes,Bossa de mà,Sabons,Sabates
Alfons Hom Picanyol: Guerrer amb espasa,Calendari
Mònica Moragues Llorente: Llibreta,Colònia,Nina morena,Sabates
Joan Iranzo Visent: Mitjons
Mònica Alba Marcu: Nina bebé,Manta,Ordinador,Jersei
Queralt Ubach Just: Jaqueta,Corbata
Carles Lluch Pedrol: Nina bebé,Colònia,Sabates,Os de peluix
Xavier Mundó Macià: Sabons,Retallable,Mocador de coll,Espasa de fusta,Jersei,Torró
Ot Terrats Viu: Mocador de coll,Conillet rosa,Ulleres de sol
Rufo Raga Marcos: Torró,Televisor,Caramels,Colònia
Toni Tubau Marata: Llapissos,Tren,Bicicleta
Marta Pastoret Lacalle: Nina bebé
Alfons Malla López: Llapissos,Torró,Nina morena,Mitxons
Zeus Gutierrez Aubert: Mòbil,Torró,Cotxe elèctric,Ràdio
Toni Llort Masdevall: Galetes,Llapissos,Cowboy,Disc de música,Bicicleta
Queralt Pinot Laborda: Llibre,Casa de nines,Bossa de mà,Estoig,Escacs,Ordinador
Marti Morillo Nogué: Televisor,Rellotge,Retallable,Mocador de coll,Bicicleta,Capsa de bombons
Magda Medina Jornet: Llapissos,Caramels,Manta,Puzzle,Ordinador,Cotxe
Baldiri Ubach Matamala: Televisor,Casa de nines,Mòbil,Joc de taula,Nina bebé,Bufanda
Sergi León Llorente: Joc de taula,Cadireta
Frances Tió Mínguez: Televisor,Mitxons,Biberó
Diego Palacios Cardona: Sabons,Manta,Sabates,Os de peluix,Arc i fletxes
Víctor Llucià Parer: Televisor,Capsa de bombons,Manta,Bicicleta,Nina rossa,Colònia
Queralt Huguet Tió: Guants,Tren
Ot Maluquer Murga: Rellotge
Max Manyé Rey: Cotxe
Paco Vinals Petrus: Ulleres de sol,Caramels,Cadireta
Víctor Mancho Hosta: Torró
Queralt Llatser Jaques: Gorro,Llibre,Mocador de coll,Cowboy
Rufo González Pi: Guerrer amb espasa,Disc de música
Iu Pou Ortega: Bufanda
Alfons Mascarell Huguet: Escacs,Mitjons
Daniel Marlés Jara: Gorro,Ràdio,Calendari,Tren
Aina Bonastre Masana: Llibre,Galetes,Colònia
Toni Llofriu Palacios: Calendari
Frances Tió Palau: Sabons,Biberó,Tren,Calendari,Cadireta,Escacs
Angela Mayné Llauradó: Corbata,Casa de nines,Sabates,Cotxe,Conillet rosa,Os de peluix
Sam Paradís Masllorens: Colònia,Guerrer amb espasa,Cotxe
Frances Morral Mallafré: Llapissos,Caramels,Sabates,Nina morena,Cadireta,Cotxe elèctric
Víctor Mitjavila : Os de peluix
Bernarda León Alcoberro: Televisor,Bossa de mà,Corbata,Estoig
Pol Marot Ordeig: Cotxe,Biberó,Espasa de fusta,Nina rossa,Ràdio
Jean Molas Albiol: Galetes,Mitxons,Calendari
Ernest Guirao Hom: Caramels,Mitxons,Rellotge,Sabates,Conillet rosa,Llibreta
Homer Pinot Perez: Televisor,Ordinador,Jersei
Enric Malé Masolivé: Jaqueta,Ordinador,Disc de música,Mitjons
Ernest Medrano Masdevall: Bossa de mà
Alfons Jornet Albiol: Estoig
Ernest Miravet Ingla: Llibre,Casa de nines,Bossa de mà,Tren,Mitjons,Ràdio
Miquel Paradís Pastoret: Mocador de coll,Puzzle,Cowboy,Arc i fletxes
Bernarda Montió Guevara: Llapissos,Biberó,Cotxe
Bernarda Maruny Pedrol: Galetes,Ulleres de sol,Ordinador,Estoig
Diego Murga Tió: Llibre,Llapissos,Sabons,Mitxons,Cowboy
Alfred Palacios Pinyas: Caramels,Jaqueta,Conillet rosa,Espasa de fusta
Homer Palacios Mans: Escacs
Daniel Marcos Jorba: Guerrer amb espasa,Estoig
Diego Monné Llach: Retallable,Mitjons,Estoig
Helena Guimerà Padrosa: Bufanda,Torró
Quim Manent Masllorens: Galetes,Retallable,Llibre,Guants,Mocador de coll
Jou Solé Guixà: Llapissos,Puzzle,Nina morena,Mitjons,Ordinador
Víctor Sabater Alemany: Tren,Casa de nines
Cesc Isern Guevara: Nina rossa,Sabates
Magda Monné Roure: Mocador de coll,Os de peluix
Pep Mercadal Terrats: Televisor,Calendari,Retallable,Mitxons,Guants,Conillet rosa
Alfred Mans Giménez: Torró,Llibreta,Disc de música,Cotxe,Biberó
Queralt Casajuana Marlés: Televisor,Bossa de mà,Biberó,Nina morena
Joan Icart Paladell: Llibre,Mocador de coll,Guerrer amb espasa,Disc de música,Cadireta
Joanot Llenas Masclans: Sabons,Rellotge,Escacs,Conillet rosa,Bufanda,Os de peluix
Merce Mercadé Mundó: Ràdio,Mitxons,Nina rossa,Tren
Filomenu Molas Murga: Mòbil,Os de peluix,Arc i fletxes
Met Ubach Lara: Gorro,Llibreta
Cristian Medina Jodar: Televisor,Guerrer amb espasa
Diego Palau Guirao: Bufanda,Guants,Corbata,Cadireta
Zeus Moragues Pallarol: Televisor,Estoig
Iu Mascarell Parer: Cadireta,Nina morena,Tren
Alfons Sabater Isern: Colònia,Guants,Sabates,Joc de taula,Casa de nines
Pepa Ortega Llenas: Llibre,Joc de taula,Nina rossa
Maria Lluisa Albí Pelegrí: Rellotge,Puzzle
Rufo Masana Mancho: Disc de música,Llapissos,Ordinador,Casa de nines
Bernarda Solé Picanyol: Ulleres de sol,Torró,Corbata,Cotxe,Disc de música
Anna Marcos Mont: Cadireta
Joan Josep Petit Montió: Jaqueta,Ordinador,Cowboy
Iu Jaques Mascarell: Ulleres de sol,Caramels,Casa de nines,Sabates,Bossa de mà
Anna Pelegrí Masolivé: Bufanda,Gorro,Torró,Disc de música,Cadireta
Daniel Alemany Pujol: Arc i fletxes,Cadireta
Jou Jorba Maurell: Ulleres de sol,Cowboy,Nina morena,Jersei,Cadireta
Diego Sonet Maurell: Conillet rosa,Cotxe elèctric,Joc de taula,Sabates
Didac Munné Rodríguez: Arc i fletxes
Helena Matamala Orobitg: Guerrer amb espasa,Jaqueta
Merce Jordana Pesarrodona: Escacs,Bufanda,Rellotge,Manta,Espasa de fusta
Carles Gasull Lloris: Televisor,Mitxons,Mitjons,Ràdio,Nina morena,Escacs
Alfons Masdefiol Marot: Calendari,Conillet rosa,Cadireta
Anna Lara Mallafré: Bufanda,Escacs,Guerrer amb espasa,Guants
Sam Pujol Jornet: Gorro,Colònia,Estoig
Sònia Llanet Montroig: Guants,Jaqueta,Arc i fletxes
Gerard Sonet Morral: Galetes,Manta,Retallable,Nina bebé,Nina morena,Escacs
Candela Pedreño Oliveras: Llibre,Bossa de mà,Rellotge,Manta,Jersei
Marti Serra Isern: Galetes,Mitxons,Ràdio
Merce Llach Padilla: Mocador de coll
Daniel Maginet Guevara: Televisor,Galetes,Capsa de bombons,Manta,Arc i fletxes
Magda Mínguez Agulla: Retallable,Calendari
Aina Just Bru: Retallable
Maria Lluisa Lloberes Pinyas: Galetes,Colònia,Espasa de fusta,Ordinador,Conillet rosa
Queralt Ricart Julià: Biberó,Manta,Nina morena,Disc de música
Miquel Llorens Huguet: Jaqueta,Tren,Sabates,Calendari,Cadireta,Ulleres de sol
Maria Lluisa Ricart Masclans: Galetes
Josep Antoni Lozano Marcó: Espasa de fusta
Carles Lloberes Brau: Ulleres de sol,Jaqueta,Espasa de fusta,Nina rossa,Cowboy
Quim Picanyol Tubau: Televisor,Galetes,Llibreta,Jersei
Fe Morillo Maurell: Mitjons,Espasa de fusta
Iu Llofriu Mínguez: Mitxons,Disc de música,Joc de taula
Maria Lluisa Mans Palop: Ordinador,Sabates
Cristian Macià León: Gorro,Bossa de mà,Guerrer amb espasa,Nina morena,Ordinador
Pere Miravet Latre: Sabons,Guerrer amb espasa,Mitjons,Joc de taula,Bicicleta,Ulleres de sol
Anna Messegué Maluquer: Rellotge,Guerrer amb espasa,Sabons,Nina rossa,Torró,Disc de música
Pepa Pijoan Taberner: Escacs
Antonia Llansana Jodar: Gorro,Nina bebé,Manta,Cotxe
Filomenu Molas Montroig: Mòbil
Didac Padilla Perez: Bufanda,Nina bebé,Sabons,Manta,Cowboy
Queralt Maginet Isern: Caramels,Guerrer amb espasa,Guants,Mitjons,Nina rossa,Ulleres de sol
Susanna Llucià : Manta,Sabates,Nina bebé,Conillet rosa,Capsa de bombons,Os de peluix
Baldiri Lloris Platja: Gorro,Bossa de mà
Zeus Puig Ingla: Llibre,Biberó,Mòbil,Nina bebé,Nina morena,Capsa de bombons
Bernarda Alcoberro Pinyas: Corbata
Maria Vives Maginet: Mitjons,Ràdio,Nina morena,Escacs,Torró,Disc de música
Cristian Oveja Not: Galetes,Bicicleta,Biberó,Nina morena,Casa de nines
Toni Guevara Hernández: Llapissos,Mitxons,Nina rossa,Jersei
Alfons Luque Lozano: Llibre,Cotxe
Anna Orobitg Lluch: Jaqueta,Sabates
Joanot Pascal Moron: Llibre
Alfred Huguet Raga: Gorro,Guerrer amb espasa,Cadireta
Joanot Petit Puig: Mitxons,Jaqueta,Mitjons
Susanna Pastoret Paraire: Joc de taula,Cotxe
Antonia Munné Llauradó: Llapissos,Llibreta,Os de peluix,Mòbil
Pol Mancho Perez: Llibreta,Mòbil,Caramels,Nina morena,Calendari
Enric Margalef Paradís: Galetes,Casa de nines,Nina bebé,Cadireta,Bufanda,Colònia
Homer Pelegrí Paraire: Galetes,Llibre,Rellotge,Escacs,Bossa de mà
Mònica Piferrer Montroig: Rellotge,Joc de taula
Cesc Llach Lloberes: Cotxe elèctric,Jaqueta
Víctor Montió Mínguez: Llapissos,Guants,Sabates
Xavier Masachs Lacalle: Corbata,Arc i fletxes
Joan Josep Palau Marata: Puzzle,Mitjons
Iu Jaques Jordana: Colònia,Guants,Cotxe elèctric,Jersei
Enric Pujol Marsà: Bufanda,Colònia,Guerrer amb espasa,Calendari,Sabates
Met Mans Julià: Colònia,Disc de música,Jersei
Candela Jordana Ortiz: Escacs,Llibreta,Ordinador,Os de peluix
Met Montià Medina: Televisor
Rufo Soler Manent: Bossa de mà,Bicicleta,Cotxe,Casa de nines
Angela Paladell Alcoberro: Llapissos,Colònia,Estoig,Tren,Cadireta
Pep López Vives: Gorro,Ràdio,Jersei,Tren
Carles González Messegué: Manta,Mòbil,Mitxons,Ulleres de sol,Disc de música,Cotxe
Joan Not Maymó: Bufanda,Guerrer amb espasa,Ordinador,Cotxe
Queralt Jara : Televisor,Puzzle,Llibreta,Jersei,Calendari
Enric Lara Lladó: Retallable,Mocador de coll,Llibreta,Sabates,Bossa de mà
Filomenu Mata Pinot: Mocador de coll
Joan Lloris Jornet: Caramels,Torró,Sabons,Jersei
Candela Albí Moron: Mitxons,Nina rossa
Zeus Tubau Perez: Galetes,Colònia,Mitxons,Os de peluix
Fe Bonaterra Lladó: Llibre,Manta,Corbata,Mòbil,Sabates,Cotxe elèctric
Sergi Llatser Marcó: Llibre,Bossa de mà,Jaqueta
Queralt Guimerà Guirao: Nina bebé,Cowboy,Guerrer amb espasa,Jersei,Casa de nines
Aina Marín Iranzo: Capsa de bombons,Nina rossa
Merce Llucià Manzano: Televisor,Rellotge,Nina morena,Corbata
Paco Albí Tió: Nina bebé,Manta
Ernest Llauradó Bonastre: Caramels,Corbata,Cotxe
Felicitat Ricart Jaques: Casa de nines,Mocador de coll,Puzzle,Mitjons,Bicicleta,Ràdio
Frances Casajuana Palop: Televisor,Cotxe,Joc de taula
Joan Josep Pijoan Petit: Retallable,Mitxons,Espasa de fusta,Cadireta
Sònia Viu Gutierrez: Caramels,Manta,Nina rossa,Bossa de mà,Nina bebé,Conillet rosa
Alfons Murga Jorba: Gorro,Llibreta,Jaqueta,Espasa de fusta,Cowboy
Frederic Mancho Malé: Mitxons,Disc de música,Nina rossa
Quim Pericas Boix: Caramels,Cadireta,Corbata,Ràdio
Josep Cardona Piferrer: Guants,Estoig,Conillet rosa,Casa de nines
Joan Lloris Mallafré: Llapissos,Torró,Llibreta
Toni Guilella Sabater: Escacs,Cowboy,Disc de música,Cotxe,Arc i fletxes
Antonia Gasull Boix: Bossa de mà,Jersei,Bicicleta,Calendari,Ulleres de sol,Torró
Queralt Matarodona Peret: Jaqueta,Mitxons,Guants,Nina bebé,Bufanda,Os de peluix
Magda Padrosa Pastoret: Mocador de coll,Estoig,Conillet rosa
Maria Lluisa Monné Maymó: Puzzle,Mitxons,Sabates,Nina rossa,Ulleres de sol,Disc de música
Bernat Latre Llatser: Colònia,Bicicleta
Paco Llanet Pastoret: Puzzle,Colònia,Jaqueta,Os de peluix
Joanot Agulla Jodar: Retallable,Escacs,Jersei,Llapissos
Josep Maruny Pey: Gorro,Biberó,Conillet rosa
Filomenu Marsà : Torró,Cotxe elèctric,Bicicleta
Xavier Iglesias Maluquer: Estoig
Antonia Orobitg Murga: Guerrer amb espasa,Capsa de bombons,Bicicleta
Josep Antoni Palau Roure: Llibre,Caramels,Estoig
Merce Mercadé Pericas: Llapissos,Guerrer amb espasa,Cotxe,Cadireta
Lluis Platja Ruiz: Sabons
Felicitat Mancho Marcet: Llibre,Nina bebé,Biberó,Estoig
Magda Lloberes Raga: Arc i fletxes,Biberó,Mitjons,Tren
Queralt  Parer: Bufanda,Casa de nines
Homer Soler Lloris: Llibreta,Cowboy,Sabates,Ràdio,Calendari,Colònia
Aina Serra Isern: Retallable,Rellotge,Cotxe elèctric,Cotxe,Tren
Joan Josep Martell Palacios: Ulleres de sol
Ot Hernández Visent: Sabons,Jaqueta,Mocador de coll,Rellotge,Sabates,Gorro
Pepa Jodar Mula: Jaqueta,Tren,Retallable,Mocador de coll,Joc de taula,Manta
Sergi Miravet Pia: Jaqueta,Casa de nines,Espasa de fusta,Escacs,Llibreta,Disc de música
Josep Antoni Llofriu Páramo: Arc i fletxes
Cesc Isern Magrinyà: Guerrer amb espasa,Cotxe elèctric,Casa de nines
Met Giménez Masclans: Escacs,Nina bebé,Torró,Sabates,Joc de taula
Cesc Masolivé Pou: Cowboy
Aina Pallejà Mercadal: Mòbil
Fe Mayans : Estoig
Met Soler Albí: Conillet rosa,Mitjons,Ràdio,Calendari,Galetes,Bicicleta
Aina Pia Guimerà: Bufanda,Cotxe elèctric,Nina rossa,Conillet rosa,Ràdio
David Jové Jodar: Llibre,Estoig,Calendari
Sergi Ruiz Hom: Cowboy,Estoig,Tren
Homer Jiménez González: Caramels,Capsa de bombons
Carles Ordeig Vinals: Televisor,Galetes,Cadireta
Frances Jiménez Llach: Caramels,Tren
Alfons Lladó Palomera: Guants,Mitjons
Felicitat Guimerà Ingla: Bufanda,Nina morena
Zeus Hom Mercadé: Bossa de mà,Casa de nines
Queralt Pinyas Moron: Mitxons,Estoig,Corbata
Helena Platja Moya: Escacs,Bicicleta,Cadireta
Jesus Ibarra Olivella: Llibre,Ulleres de sol,Guants,Bicicleta
Jean Agulla Isern: Llibre,Jersei,Sabates,Arc i fletxes
Cristian Albí Monells: Galetes,Puzzle,Manta,Rellotge
Cesc Manyé Visent: Llapissos,Llibreta,Nina rossa
Sergi Latre Mayans: Mocador de coll,Sabons,Cotxe elèctric,Manta,Cadireta
Zeus Vilamoll Gual: Mitjons,Nina rossa
Quim Cardona Just: Ordinador,Tren
Jean Paladell González: Gorro,Nina morena,Estoig,Sabates,Corbata
David Llobet Molas: Casa de nines
Carles Pelegrí Pedreño: Escacs,Llapissos,Estoig,Bufanda
Paco Mercadé Masmitjà: Conillet rosa
Rufo Masllorens Laborda: Gorro,Torró,Nina rossa,Arc i fletxes
Jesus Mans Huguet: Gorro
Bernat Junyent Mancho: Rellotge,Disc de música,Conillet rosa
Joanot Masllorens Fernàndez: Llibre,Bossa de mà,Jaqueta,Bicicleta
Jean Medina Gual: Galetes,Torró,Manta,Sabates,Casa de nines
Sam Llorens Malla: Televisor,Caramels
Joan Messegué Taberner: Bossa de mà,Ulleres de sol,Puzzle,Arc i fletxes
Miquel Negre Matute: Mocador de coll,Llibreta,Cotxe,Jersei
Max Matarodona Masmitjà: Bossa de mà,Arc i fletxes
Felicitat Lladó Montió: Os de peluix
Jou Palau Julià: Llibre,Rellotge,Mitjons,Ordinador
Pol Llorens Pellicer: Nina bebé
Rufo Nogué Llauradó: Llapissos,Llibreta,Manta,Cotxe,Bicicleta
Max Vives Vilamoll: Ordinador,Cowboy
Joan Guilella Icart: Llibreta,Mocador de coll,Nina bebé,Arc i fletxes,Colònia,Disc de música
Cesc Marsà Jordana: Capsa de bombons,Mitjons,Ordinador
Quim Medrano Llofriu: Ulleres de sol,Capsa de bombons,Estoig,Conillet rosa,Ràdio
Met Visent Ordeig: Ordinador
Angela Pitarch Moragues: Caramels,Nina morena,Guants
Enric Iranzo Moya: Bufanda,Colònia,Estoig,Mitjons,Ordinador
Joan Josep Marcos Marqués: Ulleres de sol,Casa de nines,Nina rossa,Tren
Miquel Masachs Paula: Puzzle
Charly Marata Oliveras: Jaqueta,Mocador de coll,Jersei,Nina bebé,Conillet rosa,Ulleres de sol
Ot Albiol Lozano: Caramels,Jaqueta,Ordinador,Estoig
Mireia González Albí: Corbata,Mitxons,Ràdio,Nina bebé,Nina rossa,Colònia
Lluis Llatser Jorba: Ulleres de sol,Sabons,Disc de música,Ràdio
Magda Marín Mitjavila: Retallable
Jean Mata Piñol: Bufanda,Nina morena,Guants,Espasa de fusta,Biberó
Jou Guvern Palop: Bufanda,Llapissos,Puzzle,Conillet rosa,Tren
Frederic Maluquer Gasull: Televisor,Sabons,Llibreta,Tren,Nina rossa,Capsa de bombons
Bernarda Laborda Gasull: Gorro,Manta,Cadireta
Sam Maluquer Bonaterra: Mocador de coll,Mitxons,Guants,Arc i fletxes,Bufanda,Cotxe
Cesc Tió Medrano: Galetes,Bossa de mà,Biberó,Sabates,Tren
Joanot Marti Guevara: Retallable,Rellotge,Llibreta,Tren
Gerard Monells Paladell: Mitxons,Capsa de bombons,Manta,Cadireta
Angela Manent Pericas: Caramels,Bicicleta
Alfons Ricart Pellicer: Escacs,Caramels,Jaqueta,Estoig,Nina rossa
Aina Ricart Jaques: Llibre,Cotxe elèctric,Cotxe
Pep Visent Lloris: Guants,Sabates
Homer Marqués Boix: Mòbil,Bicicleta
Quim Marata Pesarrodona: Mòbil,Biberó,Jersei
Lluis Viu Solé: Rellotge
Josep Antoni  Ruiz: Gorro,Capsa de bombons,Guerrer amb espasa,Manta
Queralt Murga Piferrer: Ulleres de sol,Sabons,Capsa de bombons,Rellotge
Pitu Mercadé Hosta: Ordinador
Pol Páramo Llucià: Puzzle
Sam Manyé Lladó: Llibre,Ulleres de sol,Guants,Disc de música,Os de peluix
Joan Maluquer Masclans: Llibre,Sabons,Cotxe elèctric,Disc de música,Jersei
Queralt Moya Juncosa: Disc de música,Espasa de fusta,Calendari,Joc de taula,Corbata
Magda Vives Lozano: Llapissos,Ulleres de sol,Ordinador,Joc de taula,Ràdio
Lluis Isanta Parra: Sabates,Arc i fletxes
Homer Oliveras Mans: Retallable,Cadireta,Nina morena,Corbata,Casa de nines
Pitu Maldonado Maurell: Gorro,Capsa de bombons,Guants,Espasa de fusta
Carles Palop Mach: Galetes,Capsa de bombons,Estoig
Maria Piqueras Mallafré: Llibre,Guerrer amb espasa,Cotxe elèctric
Ot Pastoret Oliveras: Os de peluix,Mitxons,Espasa de fusta,Sabates,Tren
Mònica Páramo Just: Llibre
Josep Morral Medina: Llibre,Jaqueta,Mitjons,Arc i fletxes,Manta,Capsa de bombons
Jesus Mallafré Masvidal: Gorro,Caramels,Mitxons,Cotxe elèctric,Biberó
Cristian Palau Gasull: Mocador de coll,Mitxons,Guants,Manta
Joaquim Ingla Guevara: Sabons,Rellotge,Sabates
Antonia Bru Mans: Cowboy,Estoig,Joc de taula,Nina bebé,Bufanda,Ordinador
Iu Petit Rey: Rellotge
Manel Luque Mancho: Bicicleta,Arc i fletxes,Os de peluix,Casa de nines
David Gual Mach: Retallable,Tren
Jou Luque Piferrer: Nina bebé,Cotxe elèctric,Sabates
Didac Masolivé Moya: Bufanda,Sabons,Nina rossa,Sabates
Iu Picanyol Serra: Disc de música,Casa de nines
Gerard Pinot Pitarch: Rellotge,Casa de nines,Calendari,Escacs,Disc de música,Cotxe
Diego Pascal León: Puzzle,Mitxons,Espasa de fusta,Cadireta
Mònica Jiménez Vinals: Conillet rosa,Mitjons,Joc de taula
Homer Lozano Magrinyà: Retallable,Corbata,Espasa de fusta,Bicicleta
Mireia Masvidal Palau: Televisor,Llapissos,Llibreta,Estoig,Mòbil
Cesc March Marcet: Llibreta
Maria Lluisa Laborda Guimerà: Caramels,Bossa de mà,Rellotge,Jersei,Ràdio,Torró
Marti Guirao Macià: Llapissos,Estoig,Nina rossa,Arc i fletxes,Colònia,Ordinador
Carles Manyé Murga: Casa de nines,Guerrer amb espasa,Nina morena,Arc i fletxes,Gorro,Llibreta
Alfred Medina Gasull: Torró,Manta
Joan Josep Albí Maruny: Mòbil,Rellotge,Mitjons,Llapissos
Didac Albiol Armengol: Conillet rosa,Sabates,Mitjons,Os de peluix
Pitu Maginet Bru: Tren
Daniel Negre Sabater: Biberó,Llapissos,Capsa de bombons,Galetes,Bicicleta
Toni Pedreño Pont: Puzzle,Llibreta,Casa de nines
Pep Pelegrí Ubach: Galetes,Llapissos,Capsa de bombons,Espasa de fusta,Arc i fletxes
Daniel Marín Agulla: Biberó,Joc de taula,Arc i fletxes
Max Juvany Palacios: Retallable,Mòbil
Òscar Lladó Negre: Sabates,Cowboy
Òscar Boix Magrinyà: Disc de música
Sònia Murga Mans: Televisor,Capsa de bombons,Torró,Jaqueta
Maria Majós Peret: Llibre,Llibreta
Carles Soler Marlés: Retallable,Ulleres de sol,Sabons,Guants,Sabates
Jou Guirao Rodríguez: Televisor,Mocador de coll,Jaqueta,Nina rossa,Casa de nines
Magda Cardona Lara: Sabates
Anna Pitarch Mercadal: Llibre,Torró,Ràdio
Felicitat Mercadé Llorens: Torró,Ràdio
Angela Pedreño Marín: Llapissos
Antonia Brunyol Juncosa: Caramels,Cowboy,Mocador de coll,Nina rossa,Ulleres de sol,Llibreta
Iu Soler Just: Colònia,Torró,Joc de taula,Calendari,Ràdio
Enric Hosta Marata: Ulleres de sol,Sabons,Sabates
Frances Orobitg Masllorens: Bossa de mà
Susanna Messegué Palau: Llibre,Corbata,Mòbil,Ulleres de sol,Capsa de bombons,Os de peluix
Helena Navajas Pinot: Ulleres de sol,Guerrer amb espasa,Manta
Alfons Pi Mercadal: Llapissos,Bossa de mà,Cadireta,Ulleres de sol,Cotxe elèctric,Os de peluix
Ernest Mercadal Brau: Gorro,Cotxe elèctric,Conillet rosa,Arc i fletxes
Lluis Marcó Ruiz: Puzzle,Capsa de bombons,Manta,Os de peluix
Angela Paladell Jiménez: Casa de nines
Ernest Agulla Pellicer: Escacs,Mòbil,Sabons,Guants,Ulleres de sol
Susanna Piñol Tubau: Joc de taula,Bicicleta
Josep Antoni Mínguez Masdevall: Llibre,Disc de música,Cotxe,Arc i fletxes
Cesc Guvern Manyé: Bossa de mà,Sabons,Colònia
Xavier Morral Aubert: Cowboy
Sergi Pou Olivella: Escacs,Bufanda,Torró,Joc de taula,Conillet rosa
Cesc Guirao Tió: Televisor,Bossa de mà,Guerrer amb espasa,Mitjons,Espasa de fusta
Anna Pitarch Jaques: Televisor,Caramels,Corbata
Manel Mitjavila Bonaterra: Nina morena,Cotxe elèctric,Mitjons
Queralt Jorba Llesera: Escacs
Pitu Soler Jorba: Tren,Mòbil,Nina morena,Galetes,Ulleres de sol,Ordinador
Joan Guixà Moragues: Cowboy
Paco Gasull Juanola: Gorro,Escacs,Jersei
David Morillo Oveja: Caramels,Conillet rosa
Sergi Guirao Jara: Capsa de bombons
Aina Icart Mans: Nina morena,Guants,Nina rossa
Joan Josep Pericas Paradís: Escacs,Cowboy,Mitxons,Jaqueta,Arc i fletxes
Maria Llort Marcu: Galetes,Nina bebé,Rellotge,Sabons,Cowboy
Didac Pia Marsany: Galetes,Jaqueta,Bicicleta
Fe Manyé Ingla: Capsa de bombons
Frederic Mercadé Llabot: Retallable,Ulleres de sol,Torró,Ordinador
Bernat Paraire Pou: Nina bebé
Merce Jové Lladó: Os de peluix,Calendari,Tren
Antonia Matarodona Tió: Llapissos,Rellotge,Jaqueta,Cotxe,Jersei
Diego Llort Magrinyà: Escacs,Biberó,Manta,Cadireta
Ot Isern Llansana: Mòbil,Biberó,Disc de música
Daniel Juvany Solé: Llapissos,Corbata,Sabates,Cadireta,Ulleres de sol,Os de peluix
Joan Palau Matarodona: Bossa de mà,Jersei,Os de peluix
Magda Ubach Guimerà: Retallable,Mòbil,Televisor
Joan Marata Bru: Bossa de mà,Sabates
Magda Munné Montràs: Llibre,Nina rossa
Antonia Guardiola Palacios: Os de peluix
Fe Paradís Pinyas: Torró,Puzzle,Mitxons,Guerrer amb espasa,Ràdio
Queralt Mans Lloberes: Rellotge,Cowboy,Bossa de mà,Ràdio,Nina rossa,Cotxe elèctric
Susanna Medrano Giménez: Jaqueta
Mònica Murga Llauradó: Nina bebé,Ràdio
Iu Ruiz Solé: Capsa de bombons,Cotxe elèctric,Jersei,Casa de nines
Josep Antoni Guevara Viu: Retallable,Bossa de mà,Biberó,Guants
Felicitat López Margalef: Cowboy
Rufo Pascal Terrats: Bufanda,Espasa de fusta
Mònica Molas Masllorens: Retallable,Sabates
Joan Rodríguez Vilamoll: Llibre,Caramels,Ordinador,Joc de taula
Charly Masolivé Petrus: Televisor,Manta,Nina rossa,Os de peluix,Arc i fletxes
Pitu Matamala Roure: Gorro,Bossa de mà,Sabates
Antonia Vives Marcu: Televisor,Colònia,Cowboy,Arc i fletxes,Cadireta,Capsa de bombons
Angela Pia Puig: Cotxe elèctric,Calendari,Disc de música,Sabates,Casa de nines
Charly Gual Peret: Escacs
Rufo Ibarra Maruny: Llibre,Biberó,Tren,Puzzle,Arc i fletxes,Cadireta
Alfred Mercadal Moron: Retallable,Nina bebé,Nina morena
Joan Julià Mancho: Nina bebé
Xavier Morillo Lloris: Espasa de fusta,Sabates
Joan Josep Rodríguez Jové: Rellotge,Guerrer amb espasa,Casa de nines,Bossa de mà,Mitxons,Disc de música
Antonia López Ortiz: Ulleres de sol,Rellotge,Jaqueta,Mocador de coll
Diego Negre Gasull: Guants,Estoig
Lluis Manyé Sonet: Nina bebé,Guerrer amb espasa,Jersei
Charly Gual Martell: Caramels,Ordinador,Sabates,Tren
Víctor Piñol Pedrol: Cadireta,Guerrer amb espasa,Sabates,Biberó
Maria Masolivé Picanyol: Televisor,Mitxons,Jersei,Nina rossa
Queralt Llorens Gutierrez: Calendari,Arc i fletxes
Toni Luque Jové: Ulleres de sol,Puzzle,Capsa de bombons,Corbata,Biberó
Felicitat Manyé Juncosa: Nina rossa,Cotxe,Os de peluix
Queralt Ingla Palau: Llapissos,Llibreta,Corbata
Daniel Mayné Latre: Mòbil,Llapissos
Homer  Sabater: Jaqueta,Sabates
Alfons Llorente Huguet: Gorro,Mitjons
Antonia Llauradó Munné: Gorro,Tren
Manel Margalef Petit: Mitxons,Manta,Corbata,Cotxe,Bicicleta
Frederic Icart Sabater: Mitxons,Guerrer amb espasa,Guants,Nina rossa,Jersei
Daniel Guirao Tubau: Corbata,Jersei
Filomenu Masana Pallarol: Gorro,Mitjons,Sabates,Bicicleta
Maria Ortega Juanola: Galetes,Puzzle,Torró,Sabates
Pol Aubert Pallejà: Llibreta,Ordinador
Max Pujol Pedreño: Llibre,Ordinador,Cotxe
Daniel Munné Llatser: Guerrer amb espasa,Sabates
Charly Brunyol Not: Televisor,Caramels,Capsa de bombons,Joc de taula,Espasa de fusta
Marta Lacalle Mercadé: Televisor,Guerrer amb espasa,Sabates,Os de peluix
Homer Parer Juvany: Sabons,Sabates
Marti Mundó Taberner: Joc de taula
Baldiri Palop Mata: Ulleres de sol,Disc de música,Sabates,Estoig
Sònia Junyent Laborda: Calendari
Bernarda Padilla Palomera: Cotxe,Os de peluix
Josep Antoni Not Guimerà: Retallable,Capsa de bombons,Joc de taula,Biberó
Ot Masdefiol Pinot: Disc de música
Diego March Rey: Ulleres de sol,Sabons,Guants,Espasa de fusta
Òscar Raga Aubert: Llibre,Os de peluix
Ernest Hosta Sonet: Sabons,Joc de taula,Sabates,Cadireta,Escacs,Os de peluix
Susanna Mont Mascarell: Escacs,Capsa de bombons,Manta,Jersei
Joan Martell Viu: Puzzle,Arc i fletxes
Mònica Jornet Brau: Mitxons,Ordinador,Arc i fletxes
David Mont Llorens: Ulleres de sol,Manta,Disc de música,Arc i fletxes
Didac Giménez Majós: Televisor,Cotxe elèctric,Joc de taula
Jou Parer Pedreño: Ulleres de sol,Sabons,Nina bebé,Mitjons,Casa de nines
Cesc Palop Peret: Capsa de bombons,Guants,Nina morena
Mònica Mundó Visent: Televisor,Mòbil,Galetes,Guants
Merce Bru Pinot: Caramels
Angela Gasull Isanta: Llibre,Mòbil,Rellotge
Sam Orobitg Moya: Gorro,Torró,Manta,Casa de nines
Sam Lloberes Jaques: Cotxe,Capsa de bombons,Disc de música,Calendari,Puzzle
Didac Gasull Maluquer: Llibreta
Candela Llauradó Llach: Rellotge,Manta,Mocador de coll,Joc de taula,Escacs,Ulleres de sol
Mònica Lara Manzano: Galetes,Cotxe elèctric,Ràdio,Bicicleta
David Monné Mercadal: Conillet rosa,Espasa de fusta
Anna Mula Hosta: Ulleres de sol,Sabons,Nina morena,Tren
Susanna Bonastre Gasull: Cotxe elèctric,Os de peluix,Tren
Pep Llofriu Guilella: Galetes,Nina rossa,Mitjons,Conillet rosa,Nina bebé
Marta Pedreño Ordeig: Bufanda,Guerrer amb espasa,Bicicleta
Pol Macrané Latre: Cotxe,Cowboy
Felicitat Piferrer Oveja: Mitxons,Mitjons,Tren
Sergi Marti Llobet: Cowboy,Jersei,Ràdio,Calendari,Arc i fletxes,Ulleres de sol
Mireia Pelegrí Brau: Bufanda,Rellotge,Guants,Arc i fletxes
Zeus Vives Ortiz: Televisor,Bossa de mà,Guerrer amb espasa,Manta,Os de peluix
Maria Lluisa Llauradó Pallejà: Mòbil,Sabates
Marta Armengol Mata: Estoig,Sabates
Manel Margalef Alemany: Puzzle,Guants
Pitu Mitjavila Llabot: Mocador de coll,Torró,Nina bebé
Joanot Mínguez Alemany: Gorro,Mòbil,Sabons,Capsa de bombons
Met Latre Hernández: Jaqueta,Sabates,Calendari
Carles Maymó Mercadal: Mocador de coll,Puzzle,Cotxe elèctric,Espasa de fusta
Helena Maurell Pia: Gorro,Guerrer amb espasa,Manta,Corbata,Mitjons
Cesc Matamala Lozano: Llapissos,Retallable,Mitxons,Escacs,Bufanda,Disc de música
Aina Matarodona Iglesias: Mòbil,Rellotge,Manta
Ernest Vilamoll Lozano: Escacs,Mòbil
Gerard Negre Alcoberro: Joc de taula
Paco Marata Pesarrodona: Sabons,Mocador de coll,Nina bebé,Bossa de mà,Capsa de bombons,Cotxe
Marti Tubau Just: Llibreta,Estoig,Os de peluix
Pitu Mallafré March: Caramels
Iu Hernández Morillo: Capsa de bombons,Ràdio
Felicitat Mundó Montió: Guerrer amb espasa,Os de peluix
Zeus Pi Pou: Puzzle,Torró,Sabons
Bernarda Mach Lladó: Galetes
Queralt Ortiz Guardiola: Sabates
Xavier Pelegrí Marata: Caramels,Sabons,Corbata,Rellotge,Bufanda,Ulleres de sol
Susanna Macià Maluquer: Biberó
Joan Vinals Palacios: Biberó,Cowboy,Espasa de fusta,Bicicleta,Jersei,Cadireta
Fe Lloris Parer: Sabates
Quim Parer Manyé: Rellotge,Ràdio
Pepa Orobitg Paladell: Nina morena,Guants,Espasa de fusta,Tren
Toni Brau Paret: Mocador de coll,Torró,Corbata
Ernest Lozano Luque: Ordinador
Baldiri Pitarch Petrus: Jaqueta,Joc de taula,Ràdio,Bufanda,Escacs,Cotxe
Iu Sonet Monells: Gorro,Nina bebé,Os de peluix,Sabates,Arc i fletxes
Quim Isern Lozano: Gorro,Torró,Ordinador,Cotxe elèctric
Filomenu Juncosa Llatser: Escacs,Bossa de mà,Mitjons,Calendari,Mòbil
Daniel Paladell López: Caramels,Sabates
Max Pastoret Maurell: Nina rossa
Pol Ricart Jaques: Escacs,Os de peluix
Joan Josep Marcet Aubert: Torró,Mòbil,Puzzle,Mitxons,Conillet rosa
Pep Palop Latre: Llibre,Llapissos
Frederic Paula Pujol: Bufanda,Bossa de mà,Caramels,Galetes
Quim Pinot Oliva: Bufanda,Mocador de coll,Corbata,Sabates
Baldiri Palau Lloberes: Gorro,Bufanda,Ordinador
Sergi Alba Jodar: Televisor,Llibre,Sabons,Mitjons
Homer Iranzo Orobitg: Sabons,Mitxons,Espasa de fusta,Cowboy
Met Isanta Lara: Galetes,Retallable,Rellotge,Sabates
Lluis Oliva Hosta: Llibreta,Joc de taula,Arc i fletxes
Merce Maginet Guimerà: Torró,Mitxons,Colònia,Tren,Cadireta
Baldiri Pinot Jaques: Galetes,Nina bebé,Sabates
Alfred Masvidal Oveja: Galetes,Mocador de coll,Nina rossa,Cotxe,Arc i fletxes
Pol Guasch Tió: Jaqueta,Sabates,Jersei
Pepa Mercadal Just: Ulleres de sol,Guerrer amb espasa,Cotxe,Conillet rosa
Bernat Masvidal Paret: Bossa de mà,Arc i fletxes,Bicicleta
Anna Jové Maurell: Rellotge,Mocador de coll,Puzzle,Guerrer amb espasa,Arc i fletxes,Bufanda
Filomenu Llatser Pericas: Televisor,Ulleres de sol
Josep Antoni Marín Masdevall: Llibre
Pitu Pujol Vilamoll: Escacs,Torró,Mitjons,Llibreta,Biberó
David González Ruiz: Arc i fletxes
Cristian Iranzo Mallafré: Llibre
Candela Majós Parra: Llibre,Nina bebé,Espasa de fusta
Josep Macià Marot: Bossa de mà,Llibreta,Jaqueta,Os de peluix,Espasa de fusta
Antonia Junyent Marcó: Galetes,Llapissos,Guants,Ordinador,Televisor
Diego Viu Alba: Retallable,Mitxons,Jersei
Didac Palau Visent: Capsa de bombons,Cotxe elèctric,Calendari,Bicicleta
Diego Paula Viu: Torró,Conillet rosa
Víctor Bru Mínguez: Gorro,Ulleres de sol,Calendari,Sabates,Arc i fletxes
Joanot Terrats Llauradó: Jaqueta,Mocador de coll,Joc de taula,Nina bebé,Gorro,Ordinador
Charly Orobitg Mínguez: Mocador de coll,Guerrer amb espasa,Bicicleta,Gorro,Bufanda,Llibreta
Filomenu Lladó López: Bufanda,Llapissos,Colònia,Corbata,Cadireta
Pep Piñol Lacalle: Escacs,Mocador de coll,Estoig,Sabates
Homer Manent Pey: Bufanda
Manel Lozano Mayné: Rellotge,Bicicleta
Carles Pey Parra: Escacs,Gorro,Cadireta
Jean Maymó Mula: Rellotge,Guerrer amb espasa,Cotxe elèctric
Maria Lluisa Magrinyà Martell: Rellotge,Corbata,Mòbil,Os de peluix,Ordinador,Cotxe
Queralt Guardiola Jorquera: Bufanda,Galetes,Torró,Espasa de fusta
Filomenu Oveja Ibarra: Llibre,Nina bebé,Cotxe,Calendari,Cadireta
Lluis Pont Molas: Llapissos,Manta,Jaqueta,Llibreta
Maria Oliveras Just: Sabates,Calendari,Estoig,Jersei,Cowboy
Ot Fernàndez Casajuana: Galetes,Cotxe elèctric,Jersei,Arc i fletxes
Ernest Llabot Masllorens: Nina morena,Os de peluix
Joanot Llatser Guevara: Llapissos,Guerrer amb espasa,Corbata
Antonia Manzano Medrano: Llapissos,Torró,Nina rossa,Os de peluix
Joan Ortega Piqueras: Escacs,Cadireta,Biberó,Arc i fletxes
Jesus Mancho Montió: Estoig
Quim Magrinyà Vilamoll: Galetes,Llibre,Puzzle,Jersei
Homer Navajas Jiménez: Llibre,Galetes,Guants,Sabates,Casa de nines
Magda Jornet Pelegrí: Biberó,Cotxe,Casa de nines
Charly Ricart Guardiola: Estoig
Iu Pijoan Orobitg: Rellotge,Corbata,Cowboy,Bossa de mà,Guerrer amb espasa,Guants
Maria Lluisa Munné Padilla: Guerrer amb espasa,Calendari
Joan Llanet Martell: Llibre,Mitxons,Corbata,Calendari
Paco Llorente Paradís: Biberó,Tren,Puzzle,Cowboy,Escacs,Os de peluix
Filomenu Iranzo Maurell: Ulleres de sol,Disc de música,Corbata
Felicitat Olivella Giménez: Rellotge,Mocador de coll,Guants,Ulleres de sol,Cotxe elèctric,Ordinador
Paco Pallejà Mercadal: Televisor,Llibre,Mocador de coll,Arc i fletxes,Bufanda,Llibreta
Charly Mayné Alba: Llapissos,Arc i fletxes,Jaqueta,Ordinador,Bicicleta
Pep Llansana Hom: Televisor,Llapissos,Llibreta,Guerrer amb espasa,Guants,Torró
Josep Antoni Llesera Palau: Nina bebé,Rellotge,Conillet rosa,Mocador de coll
Lluis Morillo Tió: Televisor,Puzzle,Llibreta,Rellotge,Nina rossa
Frederic Masmitjà Jaques: Corbata,Conillet rosa,Ordinador
Miquel Giménez Jornet: Bossa de mà
Alfred Negre Sonet: Sabates,Mitjons,Conillet rosa,Ràdio
Zeus Juncosa Ortiz: Cotxe
Sònia Pey Solé: Gorro,Rellotge,Sabons
Iu Solé Pont: Ulleres de sol,Nina rossa
Aina Platja Marqués: Galetes
Baldiri Alemany Montràs: Gorro
Charly León Mitjavila: Retallable,Galetes,Arc i fletxes,Conillet rosa,Cowboy
Baldiri Matarodona Just: Biberó,Cadireta,Ràdio
Max Lluch Masclans: Bufanda,Sabons,Caramels,Estoig
Didac Julià Latre: Escacs,Televisor
Pep Munné Iranzo: Guants,Capsa de bombons,Manta,Calendari,Cowboy
Aina Mayans Pia: Ulleres de sol,Mitxons
Víctor Pedreño Llauradó: Retallable,Gorro,Puzzle,Joc de taula,Cadireta
Pep Junyent Lladó: Colònia,Joc de taula,Bicicleta
Bernat Bru Jorba: Sabates,Tren
Pepa Masvidal Hosta: Bufanda,Puzzle
Pepa Ortiz Lluch: Os de peluix
Didac Linares Oveja: Disc de música
Manel Pedrol Masolivé: Puzzle,Colònia,Biberó
Paco Juanola Sonet: Rellotge,Torró,Manta,Jersei,Cowboy
Sergi Llabot Masolivé: Capsa de bombons,Manta,Mitjons,Conillet rosa,Llibreta,Disc de música
Joan Taberner Roure: Retallable,Bufanda,Caramels,Escacs,Calendari
Antonia Monells Guimerà: Torró,Nina bebé,Guerrer amb espasa,Ràdio
Xavier Pastoret Murga: Mòbil
Paco Vives Isern: Televisor,Sabates,Mòbil,Espasa de fusta,Joc de taula,Escacs
Maria Junyent Llobet: Capsa de bombons
Lluis Guirao Masmitjà: Gorro,Bossa de mà,Caramels,Cotxe elèctric,Estoig
Jesus Platja Montràs: Gorro,Capsa de bombons,Cadireta
Quim Pedreño Jové: Televisor,Jaqueta,Puzzle,Nina bebé,Llibreta,Disc de música
Iu Solé Mayans: Mocador de coll,Joc de taula,Arc i fletxes
Frederic Marcó Pi: Cadireta,Manta,Casa de nines
Queralt Lloris Palop: Llibre,Mòbil,Os de peluix
Miquel Pastoret Terrats: Torró,Jersei,Nina rossa,Espasa de fusta,Cadireta
Joaquim Marcu Masachs: Bicicleta,Sabons,Corbata,Ràdio,Galetes,Llibreta
Frances Llansana Llobet: Corbata
Frances Pallejà Molas: Llibre,Bossa de mà,Os de peluix,Sabates
Josep Soler Pericas: Bufanda,Colònia,Mitxons,Casa de nines
Zeus López Alcoberro: Galetes
Felicitat Maymó Juvany: Gorro,Mocador de coll,Guerrer amb espasa
Ot Palomera Medina: Nina morena,Estoig,Sabates,Ràdio
Anna Lladó Marti: Ulleres de sol,Nina morena,Cowboy
Rufo Pelegrí Leal: Bufanda,Galetes,Guerrer amb espasa
Ernest Tió Latre: Os de peluix
Candela Raga Guirao: Puzzle,Manta,Cotxe
Pep Murga Bru: Rellotge,Corbata,Calendari,Bicicleta
Charly Montià Pelayo: Mitjons
Queralt Monells Peret: Retallable,Bossa de mà,Puzzle,Guants,Cadireta
Sònia Tió Montià: Gorro,Joc de taula,Sabates
Lluis Martell Marsany: Televisor,Llapissos,Retallable,Guants,Joc de taula,Ulleres de sol
Gerard Olivella Hernández: Cadireta
Alfons Alcoberro Majós: Escacs,Nina rossa
Ernest Manent Lozano: Mòbil,Rellotge,Os de peluix,Nina rossa,Bicicleta
Queralt Marsà Munné: Bufanda,Manta,Mitxons,Jaqueta,Casa de nines
Frances Hom Hosta: Biberó,Ulleres de sol,Nina morena,Tren,Bicicleta
Maria Petit Juanola: Llapissos,Corbata,Torró,Ordinador,Bicicleta
Enric Maldonado Llobet: Televisor,Capsa de bombons,Caramels,Colònia
Marta Fernàndez Magrinyà: Tren
Cristian Manzano Petit: Bossa de mà
David Picanyol Majós: Cotxe elèctric
Filomenu Roure Hom: Retallable,Televisor,Llibre
Didac Linares Ibarra: Galetes,Escacs,Guerrer amb espasa,Sabates,Cowboy
Ernest Pallarol Moragues: Mòbil,Guerrer amb espasa
Cesc Marcos Mascarell: Arc i fletxes,Retallable,Tren,Disc de música,Casa de nines
Angela Boix Palau: Guerrer amb espasa,Estoig,Bicicleta
Òscar Pi Ubach: Bossa de mà
Magda Vives Laborda: Guants
Aina Ruiz Peret: Escacs
Xavier Manzano Platja: Ordinador,Jersei
Òscar Páramo Maginet: Manta,Tren,Ràdio,Nina bebé,Bicicleta,Disc de música
Gerard Cardona Ortiz: Escacs,Llibreta,Joc de taula
Bernat Maruny Luque: Nina morena,Cotxe,Tren
Sam Pericas Magrinyà: Mòbil,Sabons,Cotxe elèctric
David Marín Jorba: Mòbil,Corbata,Arc i fletxes
Homer Mancho Olivella: Bicicleta,Ordinador,Cotxe,Ràdio
Sam Masolivé Manyé: Tren
Xavier Sabater Icart: Manta
Sam Not Mans: Retallable
Bernarda Marqués Petit: Puzzle,Cowboy
Angela Palacios Palau: Llibre,Llapissos,Rellotge,Biberó,Casa de nines,Calendari
Lluis Pellicer Navajas: Tren,Retallable,Sabates,Bicicleta,Nina bebé,Conillet rosa
Pep Medrano Jorba: Llapissos,Torró
Magda Margalef Manent: Casa de nines,Puzzle,Sabates,Escacs,Calendari,Bufanda
Miquel Mínguez Oveja: Caramels,Sabates
Mireia Latre Roure: Colònia,Disc de música,Jersei,Cadireta
Enric Malla Brau: Escacs,Nina morena,Jaqueta,Mitjons
Xavier Oveja Masolivé: Retallable,Corbata
Jesus Pericas Munné: Gorro,Rellotge,Manta,Tren
Sam Masolivé Jara: Llapissos,Capsa de bombons,Corbata,Espasa de fusta,Ulleres de sol
Manel Mayné Mayné: Llibre,Mòbil
Frances Pi Masvidal: Nina bebé,Manta,Ordinador
Quim Matarodona Iglesias: Biberó,Joc de taula
Josep Antoni Margalef Lluch: Ulleres de sol,Casa de nines,Mocador de coll
Alfred Pericas Viu: Retallable,Colònia,Ordinador,Casa de nines
Baldiri Oveja Pesarrodona: Televisor,Cotxe elèctric,Puzzle,Espasa de fusta,Nina morena,Colònia
Felicitat Isern Brau: Biberó,Mocador de coll,Os de peluix,Nina rossa,Galetes,Cotxe
Bernarda Olivella Malé: Escacs,Puzzle,Torró,Disc de música,Tren
Enric Martell Jorquera: Bufanda,Sabons,Os de peluix
Sònia Lloberes Mitjavila: Capsa de bombons,Nina rossa
Sònia Padilla Pedrol: Sabons,Bicicleta
Manel Ruiz Marlés: Arc i fletxes
Diego Jiménez Maldonado: Caramels,Mitjons
Met Palop Jodar: Llibre,Mocador de coll,Guerrer amb espasa,Televisor
Joaquim Bonastre Lloberes: Nina morena,Nina rossa
Cristian Matamala Llenas: Gorro,Disc de música,Corbata,Calendari,Cowboy
Mònica Pesarrodona Raga: Nina bebé,Corbata,Bicicleta
Toni Terrats Moragues: Torró
Joanot Pairó Hernández: Llibre,Escacs,Disc de música,Cotxe
Pep Molas Pedreño: Nina bebé,Bossa de mà,Torró,Cotxe,Biberó
Paco Visent Llansana: Caramels
Met Maruny Pou: Corbata,Espasa de fusta,Arc i fletxes
Enric Pitarch Manent: Bicicleta,Guerrer amb espasa,Mitjons,Casa de nines,Ràdio
Pitu Ortiz Ricart: Retallable,Disc de música
Maria Paula Llobet: Gorro,Biberó,Jaqueta,Estoig
David Molas Pesarrodona: Mocador de coll,Caramels,Colònia,Calendari
Joanot Llucià Llorente: Casa de nines
Víctor Ortiz Nogué: Bossa de mà,Jaqueta
Bernarda Monné Iranzo: Os de peluix,Bossa de mà,Estoig,Conillet rosa,Mitjons
Lluis Maluquer Mallafré: Ordinador,Tren
Paco Pujol Orobitg: Televisor,Manta,Tren,Mòbil,Bicicleta,Bufanda
Met Raga Morral: Retallable,Nina bebé,Guants,Bicicleta
Paco Masdefiol Gutierrez: Gorro,Mòbil,Cotxe elèctric
Marti Mayans Solé: Rellotge,Corbata,Mocador de coll,Sabons,Sabates,Bicicleta
Cristian Ibarra Montió: Galetes,Capsa de bombons,Biberó,Sabates,Arc i fletxes
Joan Pallejà Paraire: Nina bebé,Guants,Bossa de mà
Homer Mans Fernàndez: Bossa de mà
Xavier Miravet Ibarra: Biberó
Toni Maymó Pi: Gorro,Retallable,Llibreta,Manta,Sabates
Cristian Puig Maluquer: Ordinador,Calendari
Met Gual Mach: Tren
Aina Vives Llanet: Torró,Corbata
Joaquim Gutierrez Terrats: Jaqueta,Tren,Jersei,Nina bebé,Calendari,Bufanda
Queralt Agulla Montroig: Mòbil
Joan Medina Parer: Galetes,Ulleres de sol,Guerrer amb espasa,Guants,Espasa de fusta
Alfred Masdevall Jornet: Galetes
Paco Malé Ordeig: Escacs,Nina bebé,Mòbil,Mitjons,Arc i fletxes
David Luque Fernàndez: Guerrer amb espasa
Antonia Mascarell Picanyol: Gorro,Nina rossa,Biberó,Sabates,Os de peluix
Charly Monné Montià: Sabates
Marti Pou Gasull: Guerrer amb espasa,Sabates,Cadireta,Gorro,Ulleres de sol,Colònia
Maria Messegué Cardona: Colònia,Disc de música,Cotxe
Frederic Cardona Marcu: Cowboy
Magda Padilla Vinals: Puzzle,Torró,Ràdio
Max Hom Munné: Puzzle,Cotxe elèctric,Espasa de fusta,Guerrer amb espasa
Bernat Pedreño Perez: Nina rossa
Gerard Pedrol Masachs: Televisor,Guerrer amb espasa,Llibreta,Estoig,Ràdio
Ot Jaques Marín: Bufanda,Joc de taula
Cristian Hom Pairó: Ordinador,Cotxe
Felicitat Paradís Marti: Capsa de bombons,Espasa de fusta
Alfred Fernàndez Icart: Escacs,Jaqueta,Os de peluix,Casa de nines
Baldiri Maurell Ricart: Televisor,Capsa de bombons,Nina rossa
Sergi Oveja Llenas: Sabons,Guerrer amb espasa,Joc de taula
Joaquim Pallejà Pey: Escacs,Ulleres de sol,Gorro,Calendari,Ràdio
Josep Tió Guirao: Colònia,Guerrer amb espasa,Manta
Sam Guardiola Montroig: Rellotge
Sònia Marot Pesarrodona: Escacs,Os de peluix
Pol Masdefiol Alemany: Manta,Cadireta
Fe Gasull Juncosa: Conillet rosa,Arc i fletxes
Ernest Marata Iglesias: Nina bebé,Ulleres de sol,Estoig,Casa de nines
Helena Pallejà Isanta: Televisor,Mitjons
Marta Lluch Guevara: Bufanda,Capsa de bombons,Mitxons,Cotxe
Víctor Martell Matamala: Llibre,Bossa de mà,Sabons,Sabates,Bicicleta
Jesus Masmitjà Ortega: Sabates,Puzzle,Ordinador,Calendari,Nina bebé
Sergi Parra Codina: Biberó,Joc de taula,Bicicleta,Sabates,Cadireta,Disc de música
Joan Pesarrodona Messegué: Jaqueta,Nina rossa
Bernat Piqueras Solé: Mitxons,Guants
Carles Giménez Pont: Llapissos,Llibreta
Ot Mayné Masclans: Capsa de bombons,Ordinador,Arc i fletxes
Jou Iranzo Casajuana: Colònia,Jaqueta,Espasa de fusta
Ernest Latre Iglesias: Puzzle,Nina morena,Sabates
Enric Guasch Llobet: Puzzle
Jesus Palacios Maginet: Mitxons,Torró,Guants,Corbata,Casa de nines
Baldiri Mitjavila Parra: Cadireta
Sam Moron Marcos: Bufanda,Mocador de coll,Ordinador,Nina rossa,Bossa de mà
Frances Ricart Palacios: Llibre,Llapissos,Tren
Queralt González Moya: Llibre,Retallable,Puzzle,Conillet rosa,Ulleres de sol,Torró
Anna León Llort: Galetes,Llapissos,Caramels,Guants,Mitjons
Frances Masvidal : Colònia,Cowboy
Daniel Mayans Masdevall: Sabons,Torró
Met Taberner Marsà: Sabons
Queralt Ricart Masclans: Cowboy,Retallable,Mocador de coll,Puzzle,Bicicleta,Nina bebé
Toni Navajas Aubert: Gorro,Mocador de coll,Cotxe elèctric,Cowboy
Fe Mayné Orobitg: Ulleres de sol,Guerrer amb espasa,Cotxe
Pol Iranzo Llauradó: Ordinador
Cristian Masdefiol León: Puzzle,Torró,Disc de música,Cowboy
Joan Rodríguez Pairó: Biberó,Cotxe elèctric
Bernarda Llenas Leal: Puzzle
Mònica Ortega Munné: Mòbil,Guerrer amb espasa,Jersei,Sabates,Ulleres de sol
Bernarda Mans Guilella: Mitjons,Sabates,Tren
Pepa Llesera Solé: Capsa de bombons,Rellotge,Colònia,Arc i fletxes
Josep Alba Llanet: Nina bebé,Jersei
Baldiri Maurell Paret: Guants
Charly Mans Majós: Retallable,Llibre,Guerrer amb espasa,Guants,Arc i fletxes
Josep Malé Leal: Llibreta
Didac Raga Maluquer: Sabates,Bossa de mà,Puzzle,Mitxons,Jersei,Espasa de fusta
Pepa Ibarra Montràs: Galetes,Puzzle,Caramels,Calendari
Filomenu Icart Ortiz: Televisor,Cowboy,Retallable,Mitxons,Conillet rosa,Os de peluix
Aina Maginet Nogué: Corbata,Joc de taula,Casa de nines
Manel Petit Mallafré: Gorro
David Pitarch Moron: Televisor,Rellotge,Jaqueta,Caramels,Bicicleta,Nina rossa
Felicitat Pitarch Juncosa: Guerrer amb espasa
Charly Guirao Boix: Biberó,Manta,Cotxe
Pol Mans Llort: Llapissos,Manta,Corbata
Jean Iglesias Guimerà: Tren
Queralt León Messegué: Nina bebé,Cotxe
Pepa Marcu Maluquer: Ordinador
Joan Mayné Mach: Mitjons
Queralt Manyé Macià: Manta,Ordinador
Homer Not Pujol: Biberó,Manta,Mitjons,Joc de taula,Tren
Xavier Montràs Pou: Arc i fletxes,Calendari,Conillet rosa,Bicicleta
Rufo Vives Monné: Caramels,Llibreta,Cowboy,Cotxe,Capsa de bombons,Os de peluix
Manel Padilla Pou: Jaqueta,Espasa de fusta,Calendari,Ràdio
Jou Llobet Mitjavila: Llibre,Estoig,Conillet rosa
Pepa Macià Lozano: Retallable,Sabons,Biberó,Nina rossa
Josep Masana Juvany: Bufanda,Bossa de mà,Nina morena,Torró,Corbata
Joanot Masclans González: Nina rossa,Caramels,Ordinador,Sabates
Felicitat Pesarrodona Hosta: Joc de taula,Sabates,Os de peluix,Disc de música
Pitu Gasull Pujol: Guerrer amb espasa
Didac Negre Soler: Puzzle
Frances Macrané Sonet: Televisor,Jaqueta,Cowboy,Disc de música,Nina morena,Ordinador
Marta Pelayo Oliveras: Gorro,Ràdio,Tren
Joanot Lluch Soler: Llibre,Manta,Retallable,Mocador de coll,Guerrer amb espasa,Cotxe
Antonia Jodar Mercadé: Televisor,Mocador de coll,Conillet rosa,Arc i fletxes
Jean Ibarra Pascal: Ulleres de sol,Guerrer amb espasa,Jaqueta
Mònica Masmitjà Pedreño: Gorro,Jaqueta,Ordinador,Mitjons
Iu Laborda Guilella: Disc de música,Joc de taula
Pitu Moya Vives: Disc de música,Bossa de mà,Mitjons,Arc i fletxes
Alfons Jorba Pericas: Rellotge,Ordinador
Filomenu Ubach Matamala: Torró,Disc de música
Joanot Pascal Marata: Ràdio,Conillet rosa,Arc i fletxes
Filomenu Tubau Raga: Rellotge,Torró,Guants,Sabates
Pep Ortiz Malé: Mocador de coll,Guants,Ordinador
Xavier Moya Casajuana: Cotxe elèctric
Helena Ubach Serra: Bufanda,Retallable,Biberó,Llibreta,Arc i fletxes
Susanna Masvidal Pelegrí: Escacs,Mocador de coll,Bicicleta,Disc de música,Bossa de mà
Òscar Brau Jornet: Puzzle,Colònia,Corbata,Jersei
Sergi Pi Gasull: Cotxe elèctric,Disc de música
Magda Marsany Icart: Mòbil,Torró,Ràdio
Helena Tubau Monné: Gorro,Televisor,Caramels,Estoig
Magda Ruiz Agulla: Caramels,Jaqueta,Jersei
Zeus Paladell Maginet: Manta,Mitjons,Sabates,Escacs,Conillet rosa,Bufanda
Charly Morral Pi: Sabates,Jersei
Joan Pairó Nogué: Jaqueta
Xavier Pedrol Maldonado: Ulleres de sol,Rellotge,Mitxons
Bernat Pedrol Llach: Escacs,Mòbil,Cotxe elèctric,Nina morena,Nina bebé
Miquel Llorente Montroig: Casa de nines
Candela Molas Medrano: Jaqueta,Jersei
Merce Piqueras Parra: Galetes,Nina bebé,Calendari,Sabates,Ulleres de sol
Candela Raga Hom: Bossa de mà,Colònia,Espasa de fusta
Alfred Miravet Masmitjà: Llibre,Tren,Bossa de mà,Espasa de fusta,Ulleres de sol,Cotxe
Fe Julià Gutierrez: Mocador de coll,Biberó
Bernat Matute Llanet: Rellotge,Biberó,Jaqueta,Sabates,Ràdio
Carles Llucià Margalef: Bufanda,Gorro,Mitjons,Nina rossa,Arc i fletxes
David Pesarrodona Mans: Retallable,Guerrer amb espasa,Manta,Mitjons,Cowboy
Homer Lozano Gasull: Capsa de bombons,Biberó
Antonia Lara Vilamoll: Rellotge,Tren,Mòbil,Jersei,Nina rossa,Os de peluix
Charly Giménez Medrano: Capsa de bombons
Bernat Llobet Páramo: Jersei,Cowboy
Xavier Palop Matute: Televisor,Guants,Estoig,Cotxe,Cowboy
Joanot Gutierrez Guirao: Bossa de mà,Cotxe
Jou Olivella Orobitg: Llibre,Llapissos,Sabons,Cowboy,Bossa de mà,Guants
Baldiri Montià Pascal: Galetes,Mitxons
Homer Monné Montià: Rellotge,Tren
Jean Macrané Maruny: Retallable,Galetes
Manel Oliva Moya: Biberó,Jaqueta,Puzzle,Joc de taula,Bicicleta,Gorro
Cristian Alemany Pia: Retallable,Ràdio
Maria Lluisa Masclans Oveja: Ràdio
Homer Murga Petrus: Bufanda,Espasa de fusta,Mitjons,Conillet rosa,Ràdio
Mireia Jové Leal: Cotxe elèctric,Nina morena,Disc de música,Calendari
Antonia Pedrol Junyent: Os de peluix
Maria Peret Serra: Galetes,Colònia,Mitjons,Bicicleta
Cesc Palomera Monné: Televisor,Caramels,Cowboy,Mocador de coll,Bicicleta,Arc i fletxes
Charly González Sabater: Manta,Guants,Joc de taula
Enric Marti Margalef: Mòbil,Caramels
Gerard Puig Masmitjà: Bicicleta,Jaqueta,Ràdio,Gorro,Galetes,Torró
Gerard Gasull Llanet: Cotxe elèctric,Corbata
Pep Pairó Alemany: Rellotge,Cowboy,Bicicleta
Alfons Ricart Latre: Llibre,Cotxe
Bernat Alemany Jodar: Llibre,Biberó,Espasa de fusta,Cadireta,Galetes,Colònia
Manel Lluch Páramo: Mòbil,Mitxons,Cotxe elèctric
Miquel Sonet Rey: Bufanda,Sabates,Mitxons,Espasa de fusta,Jersei
Joan Josep Guilella Icart: Galetes,Mocador de coll,Llibreta,Guants,Televisor
Marta Lluch Manent: Llibreta,Casa de nines,Espasa de fusta,Calendari,Capsa de bombons,Ordinador
Pol Casajuana Marata: Nina bebé,Puzzle,Rellotge,Cadireta
Mireia Macià Messegué: Estoig
Maria Lluisa Llansana Albí: Capsa de bombons,Nina morena,Conillet rosa
Alfons  Giménez: Joc de taula
Pitu Jodar Pi: Mòbil,Cadireta
David Masachs Marlés: Nina morena,Biberó,Mitjons,Bicicleta
Joan Josep Morillo Lloberes: Cowboy,Casa de nines,Estoig,Bicicleta,Ràdio,Os de peluix
Josep Antoni Martell Morillo: Mocador de coll,Colònia
Merce Jornet Pallejà: Rellotge,Manta,Caramels,Jersei,Colònia,Disc de música
Ernest Vinals Albí: Mòbil,Capsa de bombons,Nina morena,Calendari
Marta Petrus Mayné: Casa de nines,Sabates,Ordinador,Ulleres de sol,Disc de música,Cotxe
Fe Lozano Mínguez: Televisor,Cotxe elèctric,Ordinador,Cotxe,Cadireta
Pere Pinot Boix: Llapissos
Maria Pellicer Tió: Espasa de fusta
Frederic Boix Marot: Llibre,Manta,Mocador de coll,Mitxons,Ràdio,Ulleres de sol
Charly Gual López: Llibre,Nina bebé,Mitxons,Jersei,Tren
Homer Ingla Brunyol: Capsa de bombons,Nina bebé,Cotxe elèctric,Sabates,Bicicleta
Quim Montià Mayans: Escacs,Espasa de fusta
Joan Marsà Jiménez: Nina rossa
Frances Palau Oliva: Ordinador
Xavier Lladó Gual: Mòbil,Calendari
Frances Palomera Mans: Ulleres de sol,Nina morena
Ot Mallafré Hom: Caramels,Torró,Arc i fletxes
Aina Junyent Murga: Mocador de coll,Caramels,Jaqueta,Rellotge,Tren
Diego Pericas González: Televisor,Mitjons
Bernarda León Ordeig: Llibre,Biberó,Nina bebé,Nina morena,Conillet rosa,Cadireta
Joaquim Jodar Pinyas: Corbata,Disc de música
Rufo Pelegrí Maruny: Galetes,Calendari,Bicicleta
Jesus Masvidal Padrosa: Sabates,Sabons,Jaqueta,Caramels,Joc de taula
Cesc Junyent Jaques: Escacs,Rellotge,Capsa de bombons,Corbata,Ràdio
Met Juvany Taberner: Mitjons,Calendari
Pitu Maruny Pallarol: Bufanda,Mocador de coll,Torró
Zeus Pairó Ricart: Escacs,Caramels,Espasa de fusta
Gerard Navajas Pey: Bufanda,Sabons,Cotxe,Espasa de fusta,Arc i fletxes
Jou Latre March: Calendari
Rufo Pou Mont: Guerrer amb espasa,Estoig,Cotxe elèctric
Joan Paladell Isanta: Caramels,Rellotge,Guerrer amb espasa,Disc de música,Nina morena
Iu Llesera Murga: Sabates,Estoig,Conillet rosa
Felicitat Juanola Malé: Capsa de bombons
Xavier Montroig Pairó: Retallable,Bossa de mà,Joc de taula,Arc i fletxes,Escacs,Llibreta
Joan Marti Pijoan: Bicicleta,Corbata,Llibreta,Arc i fletxes
Pitu Hom Luque: Galetes,Ulleres de sol,Jersei,Corbata,Conillet rosa
David Padrosa Solé: Gorro,Colònia
Rufo Malla Guevara: Casa de nines,Mitxons,Sabates,Espasa de fusta,Gorro,Llibreta
Quim Martell Padilla: Llapissos,Caramels,Tren,Bufanda,Torró,Cotxe
Miquel Masdefiol Palomera: Gorro,Caramels,Ordinador,Cadireta
Felicitat Codina Llauradó: Mòbil,Rellotge,Llibreta
Òscar Morral Martell: Colònia
Frederic Codina Taberner: Bufanda,Tren
Joan Llucià Margalef: Sabons,Corbata,Tren,Bossa de mà,Puzzle,Casa de nines
Ernest Matamala Raga: Rellotge,Biberó,Espasa de fusta
Antonia Jordana Lluch: Llibre,Capsa de bombons,Ordinador,Sabates
Antonia Montió Petrus: Corbata
Zeus Majós Munné: Mocador de coll,Rellotge
Helena Brunyol Hosta: Os de peluix,Capsa de bombons,Nina rossa,Sabates,Disc de música
Toni Martell Iranzo: Ulleres de sol,Capsa de bombons,Llapissos
Joaquim Montroig Ruiz: Mòbil,Rellotge
Diego Pallarol Magrinyà: Cotxe elèctric,Corbata,Mitjons
Sònia Páramo Monells: Jaqueta,Disc de música,Bicicleta
Candela Huguet Ordeig: Galetes
Sam Negre Mans: Televisor,Mitjons,Joc de taula,Escacs,Bufanda,Ulleres de sol
Helena Manzano Pont: Manta,Mòbil,Mitxons,Estoig,Ulleres de sol,Capsa de bombons
Susanna Llabot Codina: Llibreta,Os de peluix,Cowboy
Miquel Cardona Aubert: Llapissos,Manta,Guants,Calendari,Ulleres de sol,Disc de música
Òscar Parra Jordana: Escacs,Mòbil,Casa de nines
Josep Antoni Nogué Huguet: Corbata,Arc i fletxes
Miquel Mans Marcet: Sabons,Nina morena,Os de peluix,Tren
Paco Morral Icart: Colònia,Bicicleta
Sònia Agulla Pallarol: Biberó
Charly Pesarrodona López: Llibre,Disc de música
Sònia Guvern Mayné: Casa de nines
Josep Antoni Pesarrodona Alba: Guants,Rellotge,Manta
Helena Medrano Jodar: Televisor,Bicicleta
Enric Pi Marsà: Biberó,Jersei,Mitjons,Llibreta
Anna Maginet Junyent: Retallable,Sabons,Colònia
Mònica Monné Marsany: Escacs,Llibre,Caramels,Manta
Gerard Padilla Pascal: Disc de música,Nina rossa
Joanot Mínguez Pujol: Caramels,Calendari,Guants,Sabons,Nina rossa,Arc i fletxes
Mireia Paradís Nogué: Sabons
Pepa Jordana Pujol: Escacs,Cotxe elèctric,Ordinador,Conillet rosa
Joan Piqueras Pedreño: Sabates,Colònia,Ordinador,Espasa de fusta
Alfons Orobitg Masllorens: Televisor,Puzzle
Josep Antoni Llorente Monells: Biberó,Ordinador,Sabates
Bernarda Maldonado Marcó: Galetes,Mòbil,Mitjons,Tren
Felicitat Lara Oveja: Nina bebé,Nina morena,Disc de música,Nina rossa,Sabates
Fe Marín Vilamoll: Escacs,Bufanda,Colònia,Gorro,Llapissos
Candela Juncosa Vinals: Caramels
Frederic Maluquer Maldonado: Llibreta,Manta,Estoig
Max Pia Julià: Capsa de bombons,Ràdio
Ernest Mont Masachs: Sabates
Bernat Taberner Palau: Jaqueta
Candela Rey Ricart: Jaqueta,Jersei
Pol Masmitjà Paret: Ràdio,Colònia,Manta,Sabates,Cowboy
Joanot Codina León: Televisor,Casa de nines,Mitxons,Sabates,Tren
Fe Lloberes Luque: Mitjons,Jersei,Tren
Mireia Molas March: Sabons,Cotxe elèctric,Manta,Estoig,Capsa de bombons,Disc de música
Jesus Lozano Masachs: Ordinador,Cadireta
Víctor Petrus Jodar: Escacs,Televisor,Jersei
David Maurell Moragues: Caramels,Corbata
Quim Viu Guirao: Sabates
Iu Jornet Páramo: Retallable,Corbata,Disc de música,Espasa de fusta,Estoig
Iu Rodríguez Macià: Puzzle,Manta,Conillet rosa,Ràdio
Charly Platja Pesarrodona: Llapissos,Manta,Sabates,Nina rossa,Mocador de coll
Joaquim Piqueras : Guants,Jaqueta,Joc de taula,Cadireta
Sònia Albí Bonastre: Sabates,Conillet rosa
Jou Pujol Morillo: Llapissos,Mocador de coll,Estoig,Conillet rosa,Galetes,Ulleres de sol
Carles Raga Marqués: Llibreta,Puzzle,Cadireta,Torró,Disc de música,Os de peluix
Enric Mayné Olivella: Mocador de coll,Llibreta,Guants
Fe Lacalle Montió: Galetes,Colònia,Mitjons,Biberó,Casa de nines
Angela Masolivé Paladell: Caramels,Manta
Víctor Guevara Mach: Galetes,Llapissos,Colònia,Estoig,Tren
Magda Mach Ubach: Cowboy,Jaqueta,Calendari,Espasa de fusta,Estoig
Joan Mayné Guardiola: Retallable,Guerrer amb espasa,Bicicleta
Didac Guilella Manent: Rellotge,Guants,Cotxe,Calendari
Felicitat Llatser Llabot: Guerrer amb espasa
Joaquim Pastoret Montràs: Mocador de coll,Cotxe elèctric,Jersei,Sabates
Carles Marín Puig: Televisor,Cotxe elèctric,Guants,Sabates,Bicicleta,Colònia
Magda Viu Maluquer: Bufanda
Maria Lluisa Montió Bonaterra: Joc de taula
Joaquim Llanet Rey: Capsa de bombons,Estoig,Sabates,Casa de nines
Manel Oliveras Llauradó: Llapissos,Puzzle,Disc de música,Cotxe,Cowboy
Joan Josep Matarodona Alba: Conillet rosa,Mocador de coll,Sabates,Calendari
Joan Guardiola Palau: Llibreta,Conillet rosa
Paco Bru Mascarell: Jersei
Susanna Jordana Marín: Conillet rosa,Sabates,Espasa de fusta,Calendari,Cadireta,Galetes
Pitu Mascarell Viu: Galetes,Ulleres de sol,Guerrer amb espasa,Bossa de mà
Ot Linares Llenas: Televisor,Cadireta,Colònia,Corbata,Cowboy
Merce Monells Pascal: Llibre,Ulleres de sol,Puzzle,Cowboy
Joan Palau Picanyol: Guerrer amb espasa,Espasa de fusta
Mònica Terrats Julià: Puzzle,Nina morena,Corbata,Espasa de fusta
Angela Llorens Llauradó: Jaqueta,Calendari,Estoig,Nina rossa,Bufanda,Manta
Mònica Junyent Monells: Caramels,Nina morena,Estoig
Cesc Masclans Guirao: Bufanda,Manta,Televisor,Guants,Conillet rosa
Joanot Maruny Mallafré: Llapissos,Caramels,Guerrer amb espasa,Espasa de fusta,Jersei
Joan Junyent Pascal: Torró,Bicicleta,Cotxe elèctric,Nina rossa,Ràdio
Bernarda Ortega Viu: Llibreta,Bossa de mà,Guerrer amb espasa,Mitjons,Gorro,Cotxe elèctric
Met Lladó Molas: Gorro,Guerrer amb espasa,Llibreta,Guants
Pitu Pallejà Picanyol: Rellotge,Guants
Pepa Vinals Raga: Bufanda,Caramels,Cotxe elèctric
Ot Vilamoll Marata: Llibreta,Joc de taula
Angela Pelayo Rey: Llapissos,Casa de nines
Pep Latre Palacios: Sabons,Biberó,Espasa de fusta,Nina morena,Sabates
Ot Morillo Morral: Nina rossa,Cowboy,Retallable,Espasa de fusta,Conillet rosa,Ordinador
Quim Jaques Malé: Colònia,Biberó,Sabates,Casa de nines
Sergi Jiménez Albiol: Guerrer amb espasa,Arc i fletxes
Ot Julià Llobet: Capsa de bombons,Biberó
Frances Pallarol Maldonado: Nina morena,Nina rossa
Quim León Rodríguez: Mitxons,Conillet rosa,Tren
Mònica Armengol Vives: Biberó,Mitxons,Os de peluix,Bicicleta
Charly Guevara Jornet: Gorro,Ulleres de sol,Caramels,Espasa de fusta,Bicicleta
Alfred Morral Lloberes: Llapissos,Ràdio
Enric Llorente Ibarra: Llibre,Mitjons,Sabates,Bicicleta
Pitu Albiol Marcu: Mitjons,Tren
Josep Mata Alba: Sabates,Cotxe,Bicicleta
Bernat Majós Luque: Mòbil
Felicitat Masdefiol Jorba: Biberó,Retallable,Mòbil,Guerrer amb espasa,Bufanda,Cotxe elèctric
Angela Not Pey: Cowboy,Ràdio,Jersei,Bicicleta
Bernarda Margalef Marata: Mitxons,Cowboy
Frances Brunyol Mayans: Gorro,Corbata,Espasa de fusta,Disc de música
Zeus Llorente Sonet: Llibre,Llapissos,Ordinador,Sabates,Arc i fletxes
Maria Lluisa Rey Mayans: Jaqueta,Jersei,Tren
Pitu Masllorens Palacios: Sabates,Sabons,Estoig,Calendari
Alfons Rey Tió: Televisor,Escacs,Joc de taula,Bicicleta
Pitu Matute Iranzo: Televisor,Cotxe elèctric,Sabates,Os de peluix
Queralt Marín Guirao: Mitxons,Sabates,Espasa de fusta,Arc i fletxes,Llibreta,Cotxe
Mònica Lloberes Julià: Mòbil
Angela Palau Palau: Llapissos
Max Masdevall Leal: Arc i fletxes,Biberó,Espasa de fusta,Os de peluix,Estoig
Joaquim Not Linares: Llibre,Nina rossa,Guants,Conillet rosa,Bufanda,Colònia
Baldiri Parra Montió: Mitxons,Mitjons,Estoig,Nina bebé,Gorro,Capsa de bombons
Susanna Serra Masdevall: Llibre,Bossa de mà,Manta,Nina rossa
Max Perez Llofriu: Mitxons,Jaqueta
Jean Lloberes Montió: Televisor,Bossa de mà,Galetes,Guants,Disc de música
Anna Marcu Soler: Nina rossa,Joc de taula,Mitxons,Cotxe,Os de peluix
Ot Navajas Jorba: Colònia,Joc de taula,Nina bebé,Nina morena,Torró,Cotxe
Toni Pey Ortiz: Mitjons,Cotxe
Víctor Llofriu Ubach: Bossa de mà,Guants,Jersei,Ràdio,Espasa de fusta,Capsa de bombons
Joan Juanola Marcó: Retallable,Caramels,Conillet rosa
Carles Piferrer Bonastre: Mocador de coll,Caramels,Manta,Sabates
Josep Páramo Roure: Caramels,Estoig
Toni Mascarell Maluquer: Rellotge,Os de peluix
Xavier Mínguez León: Gorro,Cowboy
Mireia Peret Piñol: Bossa de mà
Merce Oveja Gasull: Ulleres de sol,Sabates,Ordinador,Nina rossa,Mitjons
Cristian Mancho Albí: Galetes,Gorro,Nina rossa
Joaquim Monells López: Televisor,Ulleres de sol,Guerrer amb espasa,Jaqueta,Nina morena
Marti Petit Gasull: Torró
Antonia Paraire Marcó: Torró,Llibreta,Nina rossa,Sabates,Cadireta
Pol Mach Gutierrez: Gorro,Bossa de mà,Caramels,Mitxons
Quim Matarodona Masdefiol: Mitjons,Calendari
Queralt Páramo Mercadal: Gorro,Guerrer amb espasa,Guants,Mitjons
Marti Moragues Juanola: Retallable,Nina bebé,Cadireta
Cristian León Manzano: Capsa de bombons,Tren
Pitu Mont Ortiz: Rellotge,Torró,Jersei
Mònica Jodar Guimerà: Llapissos,Rellotge,Biberó,Mocador de coll,Joc de taula,Colònia
Frances Mitjavila Pelegrí: Televisor
Mireia Paula Jové: Biberó
Queralt Mundó Palacios: Bufanda,Torró,Llibre,Biberó,Joc de taula
Mireia Jornet Piñol: Estoig,Ràdio
Pitu Petit Moya: Mòbil,Cotxe elèctric,Corbata
Maria López Petrus: Puzzle,Joc de taula
Mireia Rodríguez Codina: Bufanda
Alfons Jordana Pedrol: Mòbil,Sabons,Os de peluix,Calendari
Candela Guvern Lluch: Llapissos,Caramels,Mocador de coll,Puzzle,Rellotge,Joc de taula
Antonia Vilamoll Platja: Mitxons
Sam Albiol Marata: Casa de nines,Ràdio,Nina morena,Calendari,Arc i fletxes,Torró
Helena Agulla Isanta: Escacs,Guerrer amb espasa,Jaqueta,Jersei,Joc de taula
Pepa Manzano Jara: Capsa de bombons,Nina morena,Cotxe
Susanna Ordeig Pia: Gorro,Nina rossa,Bicicleta
Pitu Pallejà Latre: Nina bebé,Caramels,Ordinador,Casa de nines
Met Pinyas Leal: Mocador de coll
Ot Hosta Peret: Bicicleta,Nina rossa,Cowboy
Josep Sabater Bonastre: Gorro,Escacs,Caramels,Jersei
Maria Guilella : Cotxe elèctric,Sabates
Frederic Isern Pallarol: Manta,Estoig,Ràdio,Galetes,Ulleres de sol,Cotxe
Marta Masllorens Hernández: Llibre
Pere Pastoret Pitarch: Gorro,Colònia,Nina morena,Jersei,Casa de nines
Diego Macià Marcó: Puzzle
Josep Antoni Pallarol Gasull: Mòbil,Joc de taula
Carles Peret Armengol: Bossa de mà,Sabates
Alfons Vilamoll Juvany: Os de peluix,Sabates
Sergi Palomera Hosta: Conillet rosa
Queralt Lladó Parra: Os de peluix,Sabates,Conillet rosa
Xavier Tubau Visent: Televisor,Llibre,Caramels,Cowboy,Mocador de coll,Sabates
Pep Miravet Ordeig: Capsa de bombons,Manta,Calendari,Sabates,Cadireta
Magda Hosta Visent: Televisor,Torró,Capsa de bombons,Conillet rosa
Maria Lluisa Palau Guasch: Cotxe elèctric,Corbata,Sabates,Nina bebé,Torró,Cotxe
Miquel Lloberes Mundó: Retallable,Puzzle,Biberó,Tren
Didac Martell Masvidal: Rellotge,Ràdio
Joaquim Montió Masvidal: Ordinador,Cowboy
Bernat Juncosa Lloberes: Torró,Nina morena,Cotxe
Alfred Lluch Maymó: Retallable,Ulleres de sol,Puzzle,Estoig,Cowboy
Queralt Llucià Marsany: Ulleres de sol,Sabons,Nina rossa
Fe Ingla Montràs: Torró
Baldiri Jaques Palau: Guants,Cadireta
Jean Marot Padilla: Puzzle,Sabates,Cowboy
Queralt Monné Guilella: Llibre,Sabons,Manta,Guerrer amb espasa,Guants,Joc de taula
Víctor Bonastre Pericas: Retallable,Espasa de fusta,Conillet rosa,Cotxe,Casa de nines
Max Malla Guasch: Ordinador
Cesc Parra Morillo: Televisor,Colònia,Corbata,Cotxe elèctric,Ràdio
Xavier Marcos Oliveras: Colònia,Cotxe elèctric,Biberó
Manel Maginet Matute: Llibreta,Guants,Mitjons,Estoig
Marti Pellicer Piferrer: Ordinador
Òscar Laborda Juanola: Nina bebé,Mitxons,Conillet rosa,Sabates,Cotxe elèctric
Bernarda Pedreño Macrané: Caramels,Corbata,Puzzle,Bicicleta,Conillet rosa,Cotxe
Iu Marot Pericas: Casa de nines
Bernat Puig Maldonado: Televisor,Mòbil,Joc de taula,Bicicleta,Calendari,Bossa de mà
Josep Antoni Vives Rey: Cowboy,Mòbil,Guerrer amb espasa,Bicicleta,Calendari,Capsa de bombons
Joan Josep Orobitg Sonet: Caramels,Jaqueta,Disc de música,Calendari,Bicicleta
Jesus Páramo Perez: Nina bebé,Nina morena
Gerard Magrinyà Piqueras: Casa de nines
Jou Lladó Masdefiol: Nina bebé,Biberó,Guants,Estoig
Angela Monné Pinot: Caramels,Guerrer amb espasa
Jou Jaques : Biberó,Calendari,Disc de música,Os de peluix
Toni Mont Sonet: Bufanda,Arc i fletxes
Maria Lluisa Tió Pujol: Mocador de coll,Puzzle,Estoig,Sabons
Met Masvidal Messegué: Capsa de bombons
Xavier Pinot Masclans: Llibre,Cotxe elèctric,Nina rossa,Sabates
Joan Pedrol Marot: Ràdio,Rellotge,Guerrer amb espasa,Sabates,Cowboy
Enric Jové Hosta: Caramels
Pol Marata Pastoret: Bufanda,Caramels
Alfons Mercadal Llatser: Retallable,Televisor,Cowboy,Sabates,Arc i fletxes
Sergi Laborda Miravet: Arc i fletxes
Josep Guilella Masdevall: Bossa de mà,Guants,Nina morena,Llibreta,Disc de música,Os de peluix
Quim Matarodona Molas: Ulleres de sol,Rellotge
Maria Lluisa Linares Mallafré: Tren,Sabates,Ràdio,Gorro,Ulleres de sol,Capsa de bombons
Angela Montià Llorens: Nina bebé,Guants,Ordinador,Casa de nines
Jean Pedreño Montroig: Biberó,Sabates,Arc i fletxes
Víctor Boix Majós: Cotxe elèctric
Cesc Llansana Just: Gorro,Llibre,Caramels,Ulleres de sol
Zeus Viu Leal: Mocador de coll,Nina morena,Cotxe
Magda Murga Llort: Retallable,Mòbil,Galetes,Joc de taula,Sabates
Bernat Agulla Ingla: Bufanda,Retallable
Lluis Tubau Monells: Mòbil
Mireia Masclans Parer: Torró,Cotxe,Tren
Baldiri Guasch Pastoret: Bufanda,Sabates,Cotxe
Pol Piferrer Boix: Televisor,Mòbil,Rellotge,Jaqueta,Corbata
David Pedreño Pinyas: Llapissos,Guerrer amb espasa,Sabates,Bicicleta
Filomenu Mercadal Medrano: Televisor,Nina morena,Manta,Sabates
Anna Piñol Juanola: Rellotge,Calendari
Pitu Marsany Mercadal: Ràdio,Llibreta,Tren
Met Palau Molas: Escacs,Llapissos,Jaqueta,Os de peluix
Didac González Pijoan: Biberó,Corbata,Mitxons,Mitjons,Joc de taula,Nina morena
Ot Marti Sabater: Retallable,Televisor,Llibre,Galetes,Conillet rosa
David Lluch Iglesias: Ràdio
Charly Mans Llucià: Colònia,Torró
Alfred Rey Montió: Sabons,Jaqueta,Cowboy,Mòbil,Escacs,Cotxe
Alfons González Llenas: Colònia,Biberó,Espasa de fusta
Magda Bonaterra Masclans: Rellotge,Disc de música
Jou Jordana Pallejà: Galetes,Mòbil,Rellotge,Os de peluix
Alfons González Oliva: Corbata,Cowboy,Puzzle,Cotxe,Ulleres de sol,Os de peluix
Joan Sabater Paula: Torró,Guerrer amb espasa,Os de peluix,Calendari
Queralt Mercadé Manent: Puzzle,Nina morena
Òscar Maymó Peret: Galetes,Rellotge,Mitjons,Casa de nines
Diego Jara Bonastre: Espasa de fusta,Casa de nines
Didac Masachs Matamala: Nina rossa
Pitu Juanola Guvern: Arc i fletxes
Joan Josep Guevara Lladó: Mocador de coll,Llibreta,Espasa de fusta,Disc de música,Os de peluix
Merce Roure Negre: Televisor,Torró,Mitjons,Os de peluix
Alfons Palau Petrus: Televisor,Colònia,Nina morena,Sabates
Antonia Mallafré Jové: Televisor,Jaqueta,Puzzle,Nina bebé,Calendari,Arc i fletxes
Lluis Oliva Luque: Ràdio
Jou Isern Mercadal: Escacs,Gorro,Biberó,Llibreta
Antonia Medrano Huguet: Llibre,Mòbil
Zeus Paraire Macià: Ulleres de sol,Rellotge,Biberó,Corbata,Mocador de coll
Sam Linares Pairó: Sabates
Pepa Parra Pericas: Colònia,Mocador de coll,Puzzle,Mitxons,Sabates,Torró
Angela Hom Mascarell: Bossa de mà,Guerrer amb espasa,Os de peluix
Helena Llatser Raga: Disc de música,Cotxe
Angela Moron Masachs: Gorro,Bossa de mà,Caramels,Biberó,Mòbil
Pepa Mercadé Paret: Llapissos
Pitu Isanta Pericas: Mòbil,Mitjons
Frederic Codina Tubau: Nina bebé,Mitxons,Cadireta
Maria Lluisa Raga Manyé: Retallable,Nina bebé
Met Alemany Manyé: Bicicleta
Ot Piqueras Petit: Escacs,Cadireta,Mitxons,Llibreta,Ràdio
Queralt Mínguez Martell: Sabons
Bernat Moron Iranzo: Llapissos,Nina bebé
Marta Ubach Lozano: Mocador de coll,Cotxe elèctric,Guants
Candela Llorens Masllorens: Televisor,Manta,Guerrer amb espasa,Jersei,Ràdio,Gorro
Max Marlés Pellicer: Televisor,Guerrer amb espasa
Miquel Mula Palau: Guerrer amb espasa,Llibreta
Joan Platja Mercadal: Puzzle,Biberó,Guants,Os de peluix
Bernat Llobet Paret: Bufanda,Corbata,Os de peluix,Arc i fletxes
Paco Páramo Llanet: Televisor,Puzzle,Capsa de bombons,Mitjons,Arc i fletxes
Aina Pascal Montroig: Llibre,Nina bebé,Retallable
Xavier Petit Guevara: Cotxe elèctric
Queralt Palacios Sonet: Capsa de bombons,Guerrer amb espasa,Jaqueta,Tren
Alfons Juvany Puig: Llapissos,Torró,Calendari,Jersei,Corbata
Ernest Aubert Pitarch: Bufanda,Os de peluix,Ràdio
Carles Llofriu Guixà: Bufanda,Nina morena
Marti Monné Masdevall: Nina bebé
Zeus Paradís Guixà: Bossa de mà,Joc de taula,Espasa de fusta,Os de peluix,Casa de nines
Daniel Marsà Serra: Mòbil,Nina bebé,Sabates,Bicicleta
Jesus Marcó Masmitjà: Caramels,Casa de nines,Corbata,Cowboy
Maria Aubert Malla: Galetes,Nina bebé,Mitxons,Espasa de fusta
Alfons Ortega Llansana: Llapissos,Sabons,Casa de nines,Os de peluix,Cadireta
Charly Pitarch Soler: Mocador de coll,Cotxe elèctric,Nina rossa,Cowboy
Candela Petrus Juncosa: Llibre,Mocador de coll,Guants,Cowboy
Bernarda Brunyol Bonaterra: Televisor,Biberó,Disc de música,Sabates
Susanna Vinals Jaques: Cowboy,Bossa de mà,Conillet rosa,Mocador de coll,Galetes,Os de peluix
Iu Monells Pou: Jersei
Fe Cardona Navajas: Guants
Didac Ibarra Martell: Conillet rosa,Bossa de mà,Capsa de bombons,Jersei,Llibreta
Candela Pastoret Masdevall: Mitxons,Guerrer amb espasa,Llapissos,Joc de taula,Tren
Pitu Pia Malé: Gorro,Televisor,Puzzle,Cotxe elèctric
Ot Lacalle Boix: Llibreta,Calendari,Os de peluix
Jean Sabater Pia: Disc de música,Casa de nines
Xavier Isanta Junyent: Llibre,Colònia,Jaqueta,Puzzle,Nina morena,Cotxe elèctric
Xavier Messegué Nogué: Ulleres de sol
Susanna Masdevall Vinals: Ulleres de sol,Biberó,Corbata,Calendari,Cowboy
Antonia Pitarch Mans: Galetes,Bossa de mà,Joc de taula,Disc de música,Cotxe
Ernest Sabater Icart: Puzzle,Tren
Diego Magrinyà Pijoan: Llibreta,Ordinador,Sabates
Pitu Moya Marsà: Espasa de fusta,Arc i fletxes
Pol Visent Lloberes: Llibre,Cotxe elèctric,Nina rossa
Frederic Pinyas Brunyol: Bossa de mà,Sabons
Bernarda Juncosa Malé: Biberó,Espasa de fusta
Charly Pericas Masmitjà: Bossa de mà,Corbata,Cadireta
Sam Mercadal Maurell: Llibreta
Marti Leal Marsany: Disc de música
Candela Nogué Guirao: Escacs,Mitjons,Joc de taula
Marta Palacios Isern: Mocador de coll,Corbata,Os de peluix
Marti Huguet Terrats: Mòbil,Guerrer amb espasa,Sabates,Llapissos
Aina Pellicer Llanet: Calendari,Mitjons,Jersei
Didac Marín Pelegrí: Corbata
Frederic Icart Pellicer: Calendari
Jou Raga Orobitg: Casa de nines,Guants,Corbata,Espasa de fusta,Disc de música
Zeus Boix Malla: Mòbil,Cowboy,Mitjons,Calendari,Ulleres de sol
Zeus Pelegrí Murga: Calendari,Ràdio
Angela Jaques Palacios: Torró,Manta,Llibreta
Maria Lluisa Guevara Pallarol: Bufanda,Sabons,Torró,Jersei,Cadireta
Joan Marlés Pellicer: Galetes
Joanot Morillo Ruiz: Os de peluix
Daniel Viu Palop: Llapissos,Jaqueta,Mocador de coll,Sabates,Joc de taula,Torró
Pere Cardona Vinals: Escacs,Mitjons,Os de peluix,Cowboy
Mònica Masachs Boix: Espasa de fusta
Frances Llofriu Hernández: Gorro,Nina morena,Mitjons
Paco Mundó Iglesias: Televisor,Caramels,Manta,Guants,Torró,Disc de música
Charly Padrosa Mont: Corbata,Calendari,Sabates,Cowboy
Alfred Pairó Llorens: Rellotge,Cotxe elèctric,Jaqueta,Casa de nines
Cristian Mercadé Brau: Torró,Mocador de coll,Colònia
Miquel Paradís Paradís: Bufanda,Biberó,Joc de taula,Arc i fletxes
Bernarda Codina Jiménez: Joc de taula,Cowboy
Joan Codina Munné: Biberó,Nina morena,Calendari,Tren
Paco Serra Tió: Escacs,Mòbil,Sabons,Manta,Tren
Sergi Lloris Hom: Guerrer amb espasa,Nina rossa,Llibreta,Arc i fletxes
Ot Pallarol Sabater: Llapissos,Manta,Joc de taula
Fe Juncosa Gual: Caramels,Arc i fletxes
Maria Lluisa Masdevall Messegué: Gorro,Mòbil,Tren
Joan Guirao Agulla: Ulleres de sol
Bernarda Marti Pascal: Torró,Mocador de coll,Cotxe elèctric,Mitjons,Mòbil
Josep Antoni Palomera Palau: Escacs,Nina morena
Jou Munné Maluquer: Mitxons
Filomenu Guilella Guilella: Mocador de coll,Espasa de fusta
Magda Masdefiol Ricart: Llapissos,Tren,Bicicleta
Met Masdefiol Pey: Escacs,Mocador de coll,Os de peluix
Ernest Lladó Palau: Colònia
Zeus Marsany Miravet: Disc de música,Ordinador,Cadireta
Joan Llorente Guvern: Bufanda,Puzzle,Mitxons,Sabates,Os de peluix
Didac Llabot Masvidal: Mocador de coll,Llibreta,Cowboy
Magda Pascal Palacios: Nina bebé,Mitxons,Joc de taula,Os de peluix,Sabates
Bernat Guasch Marata: Gorro,Capsa de bombons
Enric Pujol Morillo: Manta,Mitxons,Guants,Cotxe elèctric,Bossa de mà
Angela Marcet Masana: Rellotge,Bicicleta,Disc de música,Cowboy
Mireia Icart Maurell: Jersei
Josep Antoni Mitjavila Alemany: Retallable,Manta,Espasa de fusta
Angela Guardiola Manent: Mòbil,Guants
Anna González Palacios: Jersei,Disc de música,Nina rossa
Frederic Pelegrí Paradís: Guants,Manta,Mitjons
Quim Mitjavila Sabater: Mocador de coll,Guerrer amb espasa,Nina rossa,Os de peluix
Filomenu Palau Pastoret: Llibre
Òscar Malé Parra: Mitxons
Joan Masachs Lladó: Capsa de bombons,Torró,Manta,Sabates
Homer Negre Viu: Televisor,Espasa de fusta
Marti Icart Petrus: Nina bebé,Sabons,Espasa de fusta,Disc de música,Sabates
Marta Morral Oliveras: Gorro,Manta
Marti Mula Juanola: Tren
Òscar Mach Aubert: Conillet rosa
Paco Huguet Peret: Llibre,Sabons,Jaqueta,Corbata,Bicicleta,Cotxe
Joan Josep Petrus Juvany: Casa de nines
Helena Mancho Soler: Mitxons,Cadireta
Didac Guixà Juvany: Televisor
Marta Jové Lara: Nina bebé,Sabates,Calendari,Estoig
Toni Tió Munné: Sabons,Manta,Mòbil,Guants,Nina rossa,Colònia
Gerard López Pesarrodona: Capsa de bombons,Ordinador
Víctor López Llucià: Sabates
Pepa Lara González: Jaqueta,Sabates,Casa de nines
Magda Isern Tió: Nina bebé,Sabates,Joc de taula,Os de peluix,Bossa de mà
Antonia Bonastre Malla: Disc de música
Aina Pinyas Jové: Biberó,Colònia,Sabates,Joc de taula,Ràdio
Fe Palau Parer: Bossa de mà,Caramels,Jaqueta,Mitjons,Joc de taula
Charly Nogué Mach: Ulleres de sol,Conillet rosa
Paco Masana Palop: Mitxons,Estoig
Queralt Jorba Tió: Bufanda,Mocador de coll,Caramels,Escacs,Llibre
Alfred López Pericas: Televisor,Ulleres de sol,Sabons,Corbata,Joc de taula
Cesc Sonet Llach: Capsa de bombons,Ulleres de sol,Cotxe elèctric,Ordinador,Gorro
Pep Jara Masllorens: Llapissos,Puzzle,Biberó,Corbata,Casa de nines
Ot Jové Maruny: Mòbil,Estoig,Corbata
Marti Not Llofriu: Nina morena,Guerrer amb espasa,Cotxe elèctric,Puzzle,Llibreta
Joan Jorba Llesera: Ràdio
Frederic Pinot Padilla: Bicicleta
Bernarda Pellicer Pou: Televisor,Casa de nines
Antonia Marsany Vilamoll: Bufanda,Llapissos
Joan Pelegrí Oliveras: Cotxe elèctric,Mitjons,Nina bebé,Biberó,Calendari,Torró
Angela Roure Just: Disc de música,Jersei,Joc de taula,Cowboy
Marta Nogué Rodríguez: Sabons
Josep Antoni Negre Lloberes: Televisor,Nina morena,Guants,Disc de música
Joan Masllorens Vives: Jaqueta,Espasa de fusta,Sabates,Calendari,Cotxe elèctric,Disc de música
Zeus Cardona Isern: Bufanda,Ulleres de sol,Corbata
Mireia Mundó Moya: Ulleres de sol,Nina morena,Jersei,Corbata,Os de peluix
Daniel Mitjavila Pallarol: Mocador de coll,Manta,Jersei
David Mata Paladell: Cowboy,Mitxons,Jersei,Bicicleta,Conillet rosa,Cotxe elèctric
Zeus Padrosa Llauradó: Nina bebé,Caramels,Espasa de fusta,Tren
Frances Paula Llauradó: Casa de nines,Bossa de mà,Mitjons,Espasa de fusta,Conillet rosa,Os de peluix
Antonia Munné Pallejà: Colònia,Mitjons,Corbata
Didac Linares Platja: Llibre,Mocador de coll,Corbata,Calendari,Nina bebé
Joanot Ortega Maruny: Jaqueta,Estoig,Joc de taula,Nina bebé,Sabates,Gorro
Josep Ingla Isanta: Guerrer amb espasa
Queralt Ubach Pastoret: Sabons,Mitxons,Disc de música,Bicicleta
Max Ordeig Mata: Televisor,Ulleres de sol,Biberó,Joc de taula,Cadireta
Sam Agulla Julià: Sabons,Ordinador,Bicicleta
Helena Lloberes Paladell: Mocador de coll,Ordinador,Casa de nines
Òscar Tubau Palau: Sabates,Sabons,Disc de música,Espasa de fusta
Carles Marín Mascarell: Colònia,Espasa de fusta,Tren
Joan Ortiz Negre: Caramels,Jaqueta,Sabates,Jersei,Cadireta,Cotxe elèctric
Sònia Pedrol Pellicer: Manta,Mòbil,Jersei,Nina bebé,Espasa de fusta,Cotxe elèctric
Cesc Laborda Giménez: Sabons,Colònia,Jaqueta,Cotxe
Antonia Jaques Pi: Mòbil
Joaquim Peret Lacalle: Nina bebé,Cotxe elèctric,Guants,Cadireta
Diego Paladell Guilella: Caramels,Casa de nines,Mocador de coll,Mitxons,Estoig,Cotxe elèctric
Frances Masclans Llesera: Cotxe elèctric,Joc de taula,Sabates
Met Malla Vilamoll: Ulleres de sol,Cadireta
Susanna Llabot Morillo: Torró,Cotxe elèctric,Jaqueta,Joc de taula,Os de peluix
Joanot Masllorens Tió: Llibre,Bossa de mà,Caramels,Ràdio
Quim Maymó Llobet: Bufanda,Biberó,Ordinador,Jersei,Disc de música
Alfons Llanet Brau: Conillet rosa,Cadireta
Felicitat Iranzo Pallarol: Caramels,Colònia,Disc de música
Rufo Llucià Lozano: Biberó,Corbata,Joc de taula
Filomenu Marlés Pedreño: Tren
Magda March Marcos: Colònia
Xavier Manent Maldonado: Nina bebé,Caramels,Conillet rosa,Os de peluix,Mitjons
Lluis Alba Masdefiol: Llibre,Cotxe,Ràdio
Frances Marcu Masclans: Guerrer amb espasa,Jersei,Nina morena,Gorro,Disc de música,Os de peluix
Frances Hernández Marata: Mòbil,Caramels
Joan Piferrer Terrats: Guerrer amb espasa
Ernest Paret Pont: Capsa de bombons,Llibreta,Estoig,Conillet rosa,Ràdio
Paco Mínguez Bonaterra: Nina bebé,Mitxons,Conillet rosa,Espasa de fusta,Estoig
Helena Monells Marcet: Llibre,Capsa de bombons,Cotxe elèctric
Susanna Guimerà Guirao: Puzzle,Mitjons,Sabates,Casa de nines
Òscar Páramo Llort: Llibre,Retallable,Torró,Calendari
Susanna Oliva Llesera: Televisor,Bufanda,Nina bebé,Sabates,Cowboy
Lluis Moron Paradís: Escacs,Rellotge,Cotxe elèctric,Cotxe,Sabates
Max Palacios Llauradó: Cadireta
Enric López Lara: Calendari,Guants,Corbata,Conillet rosa
Xavier Moragues Lara: Jersei
Rufo Isern Jara: Sabons,Os de peluix
Sònia Icart Navajas: Televisor,Llapissos,Jaqueta,Cowboy,Bossa de mà,Cadireta
Iu Junyent Paraire: Escacs,Bossa de mà,Llibre,Torró,Ràdio
Manel Pascal Matute: Cotxe
Víctor Jorquera Pijoan: Cowboy
Joan Montió Llansana: Llibreta,Espasa de fusta,Disc de música,Calendari
Toni Marcó Parer: Ulleres de sol,Joc de taula,Manta,Ordinador,Cotxe
Diego Mans Ricart: Arc i fletxes,Sabates,Casa de nines
Ernest Maluquer Palomera: Biberó,Nina morena,Estoig,Corbata
Antonia Masclans Hosta: Biberó,Jersei,Tren
Maria Lladó Pedreño: Gorro,Espasa de fusta,Estoig,Nina rossa,Ràdio
Bernat Jiménez Montràs: Mòbil,Espasa de fusta,Ràdio,Sabates,Gorro,Os de peluix
Alfred Marsà Soler: Mitxons,Calendari,Mitjons,Os de peluix,Disc de música
Rufo Monells Ibarra: Tren,Nina bebé,Os de peluix,Calendari,Colònia,Cotxe
Bernarda Mundó Ingla: Caramels,Conillet rosa
Joan Palomera Brau: Guerrer amb espasa,Cowboy
Didac Pujol Masmitjà: Nina bebé,Jaqueta
Òscar Jodar Paula: Galetes,Ulleres de sol,Mitjons,Cotxe,Mocador de coll
Charly Vives Just: Bossa de mà,Sabates,Bicicleta
Josep Masolivé Ibarra: Llibre,Torró,Cotxe elèctric,Mitjons,Sabates
Joan Josep Cardona Matamala: Gorro,Cotxe elèctric,Jersei
Candela Guirao Maginet: Gorro,Estoig
Daniel Magrinyà Alemany: Llapissos,Puzzle,Disc de música,Galetes,Llibreta,Ordinador
Iu Casajuana Matamala: Televisor,Mocador de coll,Disc de música,Jersei,Arc i fletxes
David Huguet Montià: Sabates,Tren
Merce Llobet Miravet: Televisor,Mòbil,Cotxe,Bicicleta
Jou Martell Monné: Colònia
Diego Maldonado Masolivé: Bufanda,Guants,Calendari
Pitu Masllorens Marsà: Llibre,Bossa de mà,Sabons,Mitjons,Ràdio
Maria Pinyas Marqués: Gorro,Biberó,Estoig,Nina rossa,Bicicleta
Maria Lluisa Pastoret Iglesias: Manta,Mitxons,Guants,Sabates,Nina rossa,Gorro
Helena Masdefiol Platja: Mocador de coll
Marta Isanta Solé: Televisor,Ulleres de sol,Colònia,Calendari
Bernat Majós Pitarch: Llapissos,Caramels,Manta,Conillet rosa,Arc i fletxes
Sergi Jodar Manzano: Llapissos,Caramels,Guants,Sabates,Bicicleta
Maria Mayné Marot: Gorro,Ulleres de sol,Cotxe elèctric,Calendari
Pitu Morillo Soler: Corbata,Colònia,Jaqueta,Mitjons,Biberó
Helena Guilella Serra: Os de peluix,Cowboy
Marti Alba Pinyas: Rellotge,Torró,Ordinador,Guerrer amb espasa,Bicicleta
Aina Ordeig Llach: Jaqueta,Rellotge,Mitxons,Guants,Joc de taula
Aina Marlés Pedrol: Ulleres de sol,Guerrer amb espasa,Jaqueta
Marti Jorquera Laborda: Televisor,Capsa de bombons,Bicicleta
Aina Bru Mancho: Llibre,Biberó,Corbata,Retallable,Mocador de coll,Conillet rosa
Gerard Masolivé Maginet: Rellotge
Alfons Llorente Macià: Llibre
Candela Montió Macrané: Bossa de mà,Espasa de fusta,Arc i fletxes
Òscar Juncosa Mont: Mitxons
Mireia Piferrer Mínguez: Televisor,Ulleres de sol,Bicicleta,Cowboy
Paco Macià Llorente: Bufanda,Jaqueta,Joc de taula
Mireia Linares Petrus: Nina bebé,Caramels
Enric Matarodona Rodríguez: Mitjons,Bicicleta
Ernest Mallafré González: Bufanda,Nina morena,Conillet rosa,Espasa de fusta,Corbata
Marta Pastoret Iglesias: Torró
Josep Aubert Armengol: Llibre,Caramels,Bicicleta,Arc i fletxes,Cadireta
Joan Medina Serra: Llibreta,Ordinador
Baldiri Murga Linares: Escacs,Llibreta,Joc de taula
Joan Josep Llort Marín: Sabons
Mònica Pey Pia: Bufanda,Escacs,Capsa de bombons
Filomenu Pinyas Palau: Os de peluix,Casa de nines,Corbata,Joc de taula,Estoig
Baldiri Munné Boix: Llibre,Ordinador
Toni Marsany Jordana: Rellotge,Guants,Arc i fletxes
Joan Josep Alba Oliva: Mitxons
Sergi Palop Brunyol: Jaqueta,Manta,Calendari
Magda Manzano Juncosa: Gorro,Mitxons
Joan Maldonado Morillo: Bufanda,Biberó,Llibreta,Jersei
Jesus Nogué Oliveras: Bufanda,Guerrer amb espasa,Jaqueta,Ordinador
Cesc Llucià Messegué: Manta
Zeus Lozano Marqués: Galetes,Retallable,Caramels,Guerrer amb espasa
Miquel Magrinyà Montió: Bufanda,Llapissos,Caramels,Jaqueta,Disc de música
Didac Sabater Pellicer: Torró,Cotxe
Pep León Palop: Colònia,Ordinador
Didac Pellicer Pi: Rellotge,Sabates,Ràdio,Nina morena,Jersei,Disc de música
Max Sonet Palau: Bufanda,Nina bebé
Mònica Guilella Lloris: Llibre,Nina bebé,Cotxe elèctric,Bufanda,Arc i fletxes
Carles Alcoberro Jordana: Mòbil,Caramels,Torró,Llibreta
Ernest Marcet Orobitg: Televisor,Retallable,Nina morena,Estoig,Mitjons
Didac Guixà Maurell: Bufanda,Nina rossa
Didac Mayné Marot: Rellotge,Joc de taula,Casa de nines
Josep Antoni Marín Piñol: Ulleres de sol,Os de peluix
Joaquim Medina Juvany: Bufanda,Cotxe elèctric
Sergi Marot Morral: Mitxons
Joan Mayans Bonastre: Gorro,Disc de música,Jersei
Frederic Manyé Pascal: Puzzle,Biberó,Manta,Nina morena,Cotxe elèctric
Helena Montràs Medina: Televisor,Casa de nines,Galetes,Cadireta,Gorro,Torró
Joan Josep Hom Jara: Calendari
Pol Masllorens Pallarol: Nina morena,Guants,Joc de taula,Conillet rosa
Lluis Moya Mans: Llapissos,Biberó,Calendari
Susanna Aubert Mercadal: Ordinador
Bernat Paladell Llucià: Ulleres de sol,Capsa de bombons,Cowboy
Mònica Miravet Vilamoll: Mitxons,Joc de taula
Josep Antoni Paladell Perez: Retallable
Jou Llort Pia: Caramels,Llibreta,Calendari
Joaquim Bonastre Montràs: Conillet rosa
Jean Huguet Maluquer: Retallable
Max Albí Brunyol: Televisor,Biberó,Mitxons,Estoig,Bicicleta,Bufanda
Max Albí Pesarrodona: Bufanda,Ràdio,Calendari,Cadireta
David Not Monné: Gorro,Casa de nines
Bernat Alba Llucià: Escacs,Corbata,Estoig,Calendari,Casa de nines
Helena Macià Manzano: Conillet rosa
Pol Jiménez Llabot: Bufanda,Nina bebé,Guants,Disc de música,Ràdio
Xavier Majós Pelayo: Guants,Puzzle,Torró,Manta,Sabates
Aina Albí Vives: Retallable,Guerrer amb espasa,Mitjons,Os de peluix
Diego López Padilla: Os de peluix
Cesc Marcos Marsà: Disc de música,Conillet rosa
Pere Juvany Jové: Casa de nines
Zeus Llorens Pitarch: Jaqueta
Cesc Palomera Just: Tren,Bossa de mà,Guants,Mitjons,Nina bebé,Conillet rosa
Gerard Agulla Pedreño: Sabons,Mitxons,Biberó
Víctor Majós Pinot: Guerrer amb espasa,Espasa de fusta,Estoig,Conillet rosa,Corbata
Lluis Brunyol Pijoan: Llibre,Televisor,Cotxe elèctric
Miquel Brunyol Pedrol: Retallable,Calendari,Cadireta
Joaquim Munné Llanet: Gorro
Maria Lluisa  Llansana: Llibre,Galetes,Sabates
Filomenu Juncosa Vinals: Llibre,Rellotge,Calendari
David Guixà Morillo: Cowboy,Mòbil,Sabates,Nina bebé,Calendari,Escacs
Paco Ricart Pijoan: Llapissos,Manta,Tren,Estoig,Escacs,Ulleres de sol
Josep Antoni Platja Pinot: Galetes,Mòbil,Colònia,Guants,Cowboy
Enric Masana Jara: Puzzle,Llibreta,Cotxe
Pep Just Solé: Mocador de coll,Biberó,Estoig,Nina rossa
Pepa Lloris Olivella: Bossa de mà,Mitjons,Sabates,Arc i fletxes
Marti Viu Pedreño: Televisor,Caramels,Puzzle,Cotxe
Lluis Malé Llauradó: Gorro,Rellotge,Torró
Max Marcos Lloris: Televisor,Sabons,Corbata,Mòbil,Sabates,Ordinador
Aina Paraire Llesera: Sabons,Biberó,Jaqueta,Arc i fletxes,Torró,Cotxe
Angela Alemany Hosta: Retallable,Ulleres de sol,Corbata,Sabates
Sònia Marot Ibarra: Bufanda,Nina bebé,Mitxons,Espasa de fusta,Calendari
Bernarda Maldonado Jara: Rellotge,Mitjons,Jersei,Bufanda,Galetes,Colònia
Merce Petrus Mercadal: Caramels,Manta
Bernat Codina Navajas: Puzzle,Cadireta
Anna Juanola Jaques: Retallable,Bossa de mà,Sabons,Manta,Nina rossa
Josep Antoni Matute Pascal: Capsa de bombons,Guerrer amb espasa,Tren,Bicicleta
Toni Sabater Olivella: Llibre,Rellotge,Corbata,Disc de música
Alfons Viu Marcet: Televisor,Escacs,Caramels,Estoig,Ràdio
Òscar Oliva Malla: Televisor,Llapissos,Mitxons,Cotxe elèctric,Sabates
Joaquim Laborda Pascal: Gorro,Televisor,Colònia,Estoig,Os de peluix
Josep Margalef Masana: Guerrer amb espasa,Conillet rosa,Casa de nines
Baldiri Juvany Maruny: Jaqueta,Cowboy,Retallable,Mitxons,Calendari,Galetes
Maria Petrus Sabater: Llapissos,Cotxe elèctric,Calendari
Met Mont Cardona: Mòbil,Manta,Mitjons,Nina rossa
Angela Masdevall Rey: Biberó,Guerrer amb espasa,Arc i fletxes,Cadireta
Charly Terrats Marlés: Sabates,Cowboy
Ernest Ibarra Guasch: Sabons,Biberó,Bossa de mà,Nina bebé,Llibreta,Disc de música
Pol Giménez Peret: Puzzle,Estoig,Calendari,Mitjons
Candela Pi Malla: Gorro,Retallable,Nina rossa,Sabates,Cadireta
Met Manent Mundó: Llibre,Joc de taula,Ràdio,Cadireta,Galetes,Colònia
Òscar Marlés Malé: Guerrer amb espasa,Ordinador
Felicitat Masdefiol Lloberes: Cowboy
Mònica Alba Solé: Galetes,Caramels,Capsa de bombons,Bicicleta
Quim Nogué Páramo: Guants,Ordinador,Espasa de fusta,Bicicleta
Joaquim Piqueras Cardona: Ulleres de sol
Maria Llabot Medrano: Televisor,Retallable,Ràdio,Calendari,Escacs,Os de peluix
Mònica Marcos Morral: Nina bebé,Caramels,Mitxons,Jaqueta,Jersei
Angela Pitarch Palop: Galetes,Escacs,Biberó,Manta
Bernat Paladell Malé: Cowboy,Bossa de mà,Puzzle,Mitxons,Mòbil,Os de peluix
Anna Vives Ruiz: Sabates,Guerrer amb espasa,Llibreta,Nina morena,Joc de taula
Mònica Pellicer Alcoberro: Ràdio,Manta,Llibreta,Guants,Llapissos
Carles Iranzo Junyent: Sabons,Jaqueta,Mitjons,Jersei,Bicicleta,Nina bebé
Cesc Ibarra Soler: Biberó,Corbata,Guerrer amb espasa,Mitjons,Joc de taula,Galetes
Queralt Guvern Palacios: Mitxons,Sabates
Paco Navajas Llenas: Calendari
Angela Juncosa Jornet: Guants
Mireia Moya Gutierrez: Guants,Estoig
Anna Maldonado Jové: Llapissos,Tren,Espasa de fusta,Nina morena,Sabates,Torró
Toni Manyé Jordana: Bossa de mà,Caramels
Homer Hom Jové: Rellotge,Jaqueta,Nina bebé,Gorro,Ulleres de sol,Torró
Josep Antoni Agulla Medina: Escacs,Jersei,Joc de taula,Sabates
Maria Lluisa Pallejà March: Galetes,Capsa de bombons
Joanot Pelayo Llanet: Nina rossa
Sònia Macrané Montràs: Espasa de fusta,Bufanda,Nina morena,Sabates,Escacs,Colònia
Mireia Manent Mallafré: Puzzle,Mitxons,Jersei
David Gual Pitarch: Escacs,Bossa de mà,Jaqueta,Disc de música
Maria Nogué Páramo: Mocador de coll,Calendari
Felicitat Agulla Bonaterra: Escacs
Magda Juanola Mula: Sabons,Capsa de bombons
Cesc Matute Vilamoll: Cotxe elèctric,Cowboy,Mocador de coll,Calendari,Gorro,Torró
Jean Agulla Palomera: Bossa de mà,Guants,Espasa de fusta,Nina bebé
Ernest Pinyas Alemany: Caramels,Jersei
Joanot Ricart Vinals: Cotxe
Felicitat Miravet Leal: Escacs,Mitxons,Guerrer amb espasa,Nina morena,Cotxe
Bernat Paradís Jiménez: Llibre,Corbata,Mocador de coll,Gorro,Llibreta,Cotxe
Quim Mans Montió: Mocador de coll,Nina morena,Nina bebé
Bernarda Masana Morillo: Escacs,Ulleres de sol,Caramels,Estoig,Espasa de fusta
Didac March Icart: Jersei,Sabates
Mireia Llanet Taberner: Tren
Rufo Maluquer Piqueras: Llapissos,Llibreta,Joc de taula
Alfred Mínguez Paula: Nina bebé,Caramels,Colònia,Llibreta,Bossa de mà
Max Huguet Llauradó: Televisor,Rellotge,Colònia,Ordinador,Puzzle
Frances Ordeig Montràs: Gorro,Biberó,Corbata
Mireia Montràs Masvidal: Mòbil,Cotxe elèctric,Mitjons
Mònica Jordana Marata: Ulleres de sol,Puzzle,Jaqueta,Joc de taula,Ràdio
Joan Guilella Brau: Bossa de mà,Corbata,Conillet rosa,Bicicleta
Pep Pellicer Gutierrez: Arc i fletxes
Pep Llanet Matamala: Colònia,Guerrer amb espasa,Conillet rosa,Joc de taula,Bicicleta
Cristian Ricart Petrus: Capsa de bombons,Guerrer amb espasa,Calendari,Mòbil
Xavier Juanola Luque: Mòbil,Rellotge,Torró,Jersei
Ot Marata Pujol: Corbata,Puzzle,Cadireta,Gorro,Torró,Disc de música
Maria Mercadé Palop: Sabates,Caramels,Cotxe elèctric,Estoig,Espasa de fusta
Met Masdevall Moron: Llibre,Mitxons
Merce Not Isanta: Mòbil,Cadireta
Quim Llobet Palau: Llapissos,Casa de nines,Mocador de coll,Sabates,Bufanda,Ordinador
Queralt Pellicer Puig: Guants,Biberó,Jaqueta,Nina rossa,Joc de taula
David Mayné Llatser: Llibre,Cowboy,Tren,Casa de nines,Bicicleta
Anna Guimerà Llesera: Retallable,Cotxe elèctric,Espasa de fusta,Casa de nines
Pitu Jordana Pallarol: Gorro,Televisor,Cotxe
Bernat Moron Pont: Caramels,Corbata,Ràdio,Calendari,Bufanda,Ulleres de sol
Alfred Jodar Hosta: Bufanda,Retallable,Caramels,Escacs
Lluis Pastoret Huguet: Mitxons,Jersei,Conillet rosa,Espasa de fusta
Pitu Ingla Negre: Bufanda,Puzzle,Guants,Sabates
Max Montràs Matarodona: Mitxons,Nina bebé,Guerrer amb espasa,Conillet rosa,Cowboy
Mireia Perez Pinot: Mitjons,Sabates,Ràdio,Nina rossa,Cotxe elèctric,Os de peluix
Baldiri Guvern Malé: Televisor,Llibreta,Biberó,Cotxe elèctric,Cotxe
Cesc Negre Huguet: Retallable,Colònia,Espasa de fusta,Sabates
Daniel Medrano Ingla: Torró,Mitjons,Conillet rosa,Colònia,Disc de música,Os de peluix
Sònia González Llabot: Televisor
Baldiri Sabater Marot: Rellotge
Candela Just Palomera: Espasa de fusta,Sabates,Arc i fletxes,Colònia,Ordinador,Os de peluix
Fe Mundó Mayné: Galetes,Ulleres de sol,Cotxe
Jesus Negre Picanyol: Calendari,Jaqueta,Disc de música,Cotxe
Joan Josep Piñol Masllorens: Os de peluix,Colònia,Espasa de fusta,Tren,Cowboy
Sergi Marcet Pericas: Bufanda,Conillet rosa
Magda Martell Maginet: Mòbil,Rellotge
Bernarda Monells Mitjavila: Sabons,Casa de nines,Guerrer amb espasa,Bicicleta,Calendari,Galetes
Pep Iranzo Paladell: Puzzle,Torró,Jersei,Nina rossa
Bernat Viu Guilella: Llibre
Miquel Monells Pascal: Cotxe elèctric
Jesus Masllorens Montroig: Ordinador,Disc de música,Calendari,Cadireta
Didac Padilla Maymó: Tren
Lluis Pascal Ubach: Escacs,Colònia,Guants,Mitjons,Arc i fletxes
Ernest Pou Pastoret: Televisor,Casa de nines,Llibreta,Arc i fletxes
Ot Malla Marti: Puzzle,Joc de taula,Sabates
Joanot Armengol Sabater: Llibre,Bicicleta,Arc i fletxes,Cotxe,Tren
Rufo Masana Perez: Manta,Retallable,Bossa de mà,Sabates,Ràdio,Galetes
Cesc Maurell Marsà: Escacs,Nina bebé,Disc de música
Sam Pairó Manzano: Galetes,Bossa de mà,Nina rossa,Ràdio
Josep Mach Masolivé: Sabons,Tren,Jaqueta,Rellotge,Bicicleta
David Palomera Vilamoll: Jersei,Conillet rosa,Mitjons
Marti Agulla Mundó: Retallable,Puzzle,Cotxe,Nina rossa
Joan Iglesias Alba: Escacs,Cowboy,Sabates,Casa de nines
Paco Llenas Manzano: Retallable
Queralt Marín Llabot: Manta,Disc de música,Sabates,Cadireta
Jesus Boix Guvern: Galetes,Ulleres de sol,Estoig,Cotxe,Casa de nines
Mireia Guardiola Lozano: Nina bebé,Capsa de bombons
Bernat Marcos Montià: Retallable,Mòbil,Mitxons,Nina rossa,Cadireta,Os de peluix
Filomenu Just Taberner: Llibreta,Guants,Sabates
Baldiri Martell Monells: Retallable
Sergi Pelegrí Hosta: Gorro,Jersei,Cotxe
Maria Albiol Lozano: Mòbil,Torró,Jaqueta,Nina bebé
Alfred Guimerà Lozano: Bufanda,Torró,Ordinador,Cotxe
Ot Guilella Agulla: Llibre,Bossa de mà,Biberó,Escacs,Mitxons
Mireia Picanyol Pedreño: Jersei
Maria Pey Pou: Sabons,Biberó,Mocador de coll,Nina rossa,Ulleres de sol,Ordinador
Bernat Llansana Montià: Bossa de mà,Guerrer amb espasa,Ràdio,Mitjons,Bicicleta
Filomenu Llorens Maluquer: Nina morena,Guants,Nina rossa
Diego Maginet Llanet: Sabons,Estoig,Sabates,Calendari,Cadireta,Capsa de bombons
Enric Manent March: Llapissos,Jaqueta,Bossa de mà,Mitxons,Estoig,Nina rossa
Zeus Mundó Rey: Televisor,Bufanda,Colònia
Iu Pesarrodona Pesarrodona: Ulleres de sol,Manta
Pol Petrus Guixà: Bufanda,Ràdio,Mitjons,Cowboy
Magda Sabater Vilamoll: Llibreta,Mitjons,Arc i fletxes
Cristian Jaques Marcet: Jaqueta,Mocador de coll,Ordinador,Nina bebé,Nina morena,Disc de música
Toni Matarodona Julià: Bufanda
Diego Lacalle Nogué: Galetes,Gorro,Sabons
Mireia Mancho Pelayo: Nina bebé,Calendari,Mocador de coll
Antonia Manyé Guevara: Corbata,Conillet rosa
Frederic Parra Piferrer: Nina bebé,Sabons,Cotxe elèctric,Casa de nines
Joaquim Pinyas Mans: Bicicleta,Corbata,Conillet rosa,Disc de música
Sergi Marsà Monné: Galetes,Torró
Josep Antoni Matarodona Pallarol: Colònia,Ordinador,Joc de taula,Casa de nines
Sergi Guasch Casajuana: Retallable,Disc de música,Tren
Jesus Orobitg Jorba: Ulleres de sol,Joc de taula
Didac Taberner Tió: Os de peluix
Jesus Masachs Munné: Nina bebé,Conillet rosa,Nina rossa,Mocador de coll
Homer Brau Maluquer: Joc de taula
Jean Masclans Raga: Bufanda,Caramels,Cadireta
Bernarda Parer Montió: Llibreta,Colònia,Sabates
Max Morillo Roure: Televisor,Biberó,Sabates
Frederic Llach Munné: Mocador de coll,Puzzle
Rufo Llanet Iranzo: Nina morena,Arc i fletxes
Marta Picanyol Monné: Bossa de mà,Llapissos
Joan Pallarol Lacalle: Nina morena,Calendari,Corbata,Espasa de fusta,Mitjons
Josep Antoni Medrano Leal: Cadireta
Paco Iglesias Palau: Ulleres de sol,Sabates
Manel Roure Brau: Conillet rosa,Jersei,Calendari,Bufanda,Torró,Os de peluix
Max León Pi: Colònia,Arc i fletxes,Cotxe,Casa de nines
Josep Matute Parra: Mòbil,Capsa de bombons,Disc de música,Espasa de fusta
Joan Josep Pinot Isanta: Gorro,Puzzle,Corbata
Jesus Rey Rodríguez: Sabons,Jaqueta,Mitxons,Nina bebé,Conillet rosa,Gorro
Joaquim Gasull Jordana: Mitxons,Sabons,Nina morena,Jersei,Ràdio
Jou Llobet Platja: Cadireta,Conillet rosa,Casa de nines
Sònia Vinals Hom: Retallable,Mòbil,Cowboy
Candela Llorens Orobitg: Gorro,Nina bebé,Guerrer amb espasa,Nina rossa
Felicitat Macià Rey: Mocador de coll
Ernest Visent Masclans: Televisor,Sabons,Capsa de bombons,Nina morena
Fe Guirao Lara: Televisor,Puzzle,Guerrer amb espasa,Espasa de fusta,Sabates
Candela Viu Pou: Galetes,Ulleres de sol,Torró,Jaqueta,Cowboy
Charly Negre Boix: Bossa de mà,Tren
Pepa Guilella Mínguez: Tren,Mitjons,Joc de taula,Espasa de fusta,Gorro,Torró
Queralt Agulla Llorens: Escacs,Mòbil,Ulleres de sol,Nina rossa,Gorro
Angela Masachs Taberner: Retallable,Nina bebé,Nina rossa,Cowboy
Candela Medina Agulla: Capsa de bombons,Nina bebé,Torró,Cotxe elèctric,Arc i fletxes
Lluis Macià Padrosa: Rellotge,Guerrer amb espasa,Guants,Corbata,Calendari
Alfred Molas Páramo: Televisor,Rellotge,Casa de nines,Joc de taula,Nina rossa,Ulleres de sol
Bernarda Piñol Linares: Os de peluix
Fe León Rodríguez: Manta,Casa de nines,Puzzle,Nina morena,Gorro,Cotxe
Mònica Masachs Manyé: Gorro,Nina morena,Joc de taula
Max Guimerà Messegué: Sabons
Mireia Llenas Casajuana: Televisor,Cotxe elèctric,Biberó,Sabates,Tren
Josep Moya Luque: Caramels,Casa de nines,Tren,Guants,Jersei,Llibreta
Queralt Marcó Palop: Retallable,Jersei
Angela Picanyol Brunyol: Cotxe elèctric,Jaqueta,Corbata,Arc i fletxes,Capsa de bombons,Cotxe
Frances Navajas Negre: Galetes,Mòbil,Sabons,Disc de música,Bufanda
Cesc Pelegrí Jornet: Retallable,Guerrer amb espasa,Capsa de bombons,Cotxe
Jou Brau Masmitjà: Jaqueta,Casa de nines,Cowboy,Nina morena,Conillet rosa,Cadireta
Aina Pelayo Juvany: Puzzle,Caramels
Antonia Pont Moragues: Llibre,Guerrer amb espasa,Guants,Bicicleta
Frederic Huguet Pinyas: Nina bebé,Llibreta
Charly Guevara Macià: Televisor,Galetes,Cadireta
Maria Lluisa Mata Lladó: Mocador de coll,Nina morena,Cotxe elèctric,Cowboy
Marti Llobet Puig: Puzzle
Angela Maluquer Llorens: Torró,Corbata
Òscar Petrus Isanta: Galetes,Nina bebé,Sabates,Arc i fletxes
Homer Sabater Margalef: Galetes,Torró,Sabates,Cadireta
Pol Puig Llesera: Escacs,Jaqueta
Sònia Pedrol Masdefiol: Nina morena
Rufo Terrats Mancho: Galetes,Mòbil,Os de peluix,Conillet rosa
Frederic Alemany Marata: Rellotge
Jean Llach Luque: Retallable,Mòbil,Puzzle,Calendari
Paco Alba Palau: Bossa de mà,Cotxe elèctric,Tren
Alfred Luque Llabot: Nina bebé,Biberó
Paco Mitjavila Guilella: Retallable,Capsa de bombons,Nina rossa,Casa de nines,Cowboy
Joaquim Brunyol Mans: Guerrer amb espasa,Tren
Mireia Jiménez Brau: Llibreta,Cowboy
Filomenu Marcu Padrosa: Bufanda,Os de peluix
Candela Alba Llucià: Guants,Disc de música,Sabates
Carles Lluch Just: Televisor
Alfons Sonet Pia: Retallable,Nina bebé,Bufanda,Bicicleta
Daniel Manyé Majós: Llapissos,Sabons,Llibreta,Joc de taula,Bossa de mà
Jesus Armengol Gual: Rellotge,Guerrer amb espasa,Estoig,Nina morena,Gorro,Colònia
Bernarda Oliva Pallarol: Llapissos,Sabons,Tren,Puzzle,Escacs,Colònia
Susanna Mercadal Masclans: Guerrer amb espasa
Cristian Paradís Pallejà: Galetes,Rellotge,Torró,Mitjons,Tren
Maria Lluisa Isern Lacalle: Arc i fletxes
Ernest Mach Brau: Nina bebé
Jean Bru Matarodona: Sabons,Bossa de mà,Mitxons,Sabates,Conillet rosa,Llibreta
Jean Marcu Sabater: Manta
Jesus Masclans Tubau: Mitxons,Espasa de fusta
Joaquim Llach Ingla: Mitjons,Sabates,Bicicleta,Conillet rosa,Capsa de bombons,Cotxe
Jesus Masmitjà Ordeig: Ulleres de sol
Bernarda Monells Bonaterra: Corbata,Calendari,Tren
Gerard Tubau Ortega: Galetes,Estoig,Joc de taula,Casa de nines
Ot Ortiz Mundó: Bufanda,Bossa de mà,Jersei
Daniel Matamala Lozano: Mitxons,Jaqueta,Sabates,Ràdio
Maria Bonastre Lozano: Mocador de coll,Guerrer amb espasa,Cotxe
Pere Pesarrodona Piqueras: Torró,Bossa de mà,Guerrer amb espasa,Manta,Calendari
Carles Malla Pericas: Retallable,Mocador de coll,Puzzle,Joc de taula,Bicicleta,Escacs
Diego Monells Codina: Bossa de mà,Arc i fletxes,Jersei,Calendari,Mòbil,Colònia
Maria Lluisa Petrus Pi: Gorro,Capsa de bombons,Nina morena,Guants,Nina bebé
Toni Marti Juanola: Calendari
Paco Nogué Mata: Mocador de coll,Sabons,Ordinador
Jean Vives Llobet: Escacs,Gorro,Mitxons
Max López Huguet: Disc de música,Mitjons,Espasa de fusta,Cowboy
Anna Mont Macrané: Puzzle,Corbata,Sabates
Miquel Platja Giménez: Llapissos,Jaqueta
Joan Masachs Juncosa: Puzzle
Baldiri Masdevall Llach: Gorro,Capsa de bombons,Calendari,Cadireta
Candela Huguet Oliva: Llapissos,Mòbil,Estoig,Tren
Anna Mach Icart: Rellotge,Nina rossa
Max Alcoberro Armengol: Mitxons,Ràdio,Nina morena,Arc i fletxes,Llibreta,Os de peluix
Marta Montió Matamala: Mitxons,Caramels,Guerrer amb espasa,Nina rossa,Cadireta
Sam Medina Matamala: Escacs,Rellotge,Corbata,Espasa de fusta
Josep Antoni Petrus Guardiola: Caramels,Capsa de bombons,Disc de música,Casa de nines
Frederic Jara Mans: Espasa de fusta
Enric Fernàndez Perez: Bufanda,Capsa de bombons,Corbata,Conillet rosa,Cadireta
Cesc Llorente Taberner: Mòbil,Puzzle,Espasa de fusta
Felicitat Oliva Lozano: Caramels,Mitxons,Puzzle,Conillet rosa
Baldiri León Palomera: Sabons,Caramels
Gerard Jorba Not: Mòbil
Met Rey Piñol: Nina rossa,Biberó,Sabates,Jersei
Daniel Llofriu León: Tren,Espasa de fusta,Ulleres de sol,Torró,Ordinador,Cotxe
Ot Llauradó Palau: Mitxons,Mitjons,Joc de taula,Nina morena,Llibreta,Cotxe
Charly Mascarell Gutierrez: Espasa de fusta,Calendari,Os de peluix
Cristian Oliveras Mula: Galetes,Mitxons,Mitjons
Manel Mínguez Tió: Bossa de mà,Rellotge,Guerrer amb espasa,Corbata,Nina rossa
Sam Isern Mayans: Llibre,Mitxons
Pere Llatser Bru: Mitjons
Joaquim Masmitjà Parra: Mòbil,Torró
Jou Lacalle Pou: Mocador de coll,Capsa de bombons,Calendari,Tren
Frederic Padrosa Mercadal: Llibre,Disc de música
Bernat Matarodona Llach: Guants
Didac Matarodona Sonet: Caramels,Biberó,Manta,Cowboy,Casa de nines,Galetes
Alfred Maurell Mínguez: Escacs
Josep Antoni Lara Marcu: Televisor,Llibre,Bicicleta,Calendari,Tren
Sam Hosta Bonastre: Nina morena
Charly Bru Guardiola: Rellotge,Sabons,Ràdio
Carles Mínguez Macià: Caramels,Rellotge
Frances Bru Sonet: Joc de taula,Bicicleta
Pol Picanyol Paladell: Caramels,Mitxons,Sabates
Met Bonaterra Palacios: Sabons,Colònia,Bicicleta
Joanot Guevara Llorente: Sabons,Cadireta
Zeus Lloberes Aubert: Televisor,Galetes,Colònia
Gerard Just Jorba: Gorro,Guerrer amb espasa,Capsa de bombons,Os de peluix
Felicitat Bru Guevara: Bufanda,Sabates,Capsa de bombons,Corbata,Calendari
Joan León Piñol: Escacs
Bernat Masana Montió: Os de peluix,Casa de nines
Max Maldonado Ordeig: Nina bebé
Cesc Jiménez Brau: Biberó,Disc de música
Zeus Mallafré Montroig: Sabons,Espasa de fusta
Manel Vilamoll Brau: Capsa de bombons,Ràdio
Bernarda Bru Rodríguez: Llibre,Estoig,Nina rossa,Tren
Susanna Mayans Isern: Ulleres de sol,Biberó,Nina morena
Anna Pastoret Raga: Caramels,Tren,Retallable,Cowboy,Espasa de fusta,Ulleres de sol
Joan Piqueras Pellicer: Televisor,Casa de nines
Iu Ortega Pujol: Retallable,Rellotge,Guants,Ordinador,Conillet rosa
Òscar Serra Messegué: Televisor,Mitjons
Cesc Masclans Llabot: Bufanda,Jaqueta,Cadireta
Maria Lluisa Junyent Iglesias: Cotxe,Colònia,Manta,Disc de música,Sabates
Carles Masclans Marcos: Llapissos
Cesc Latre Ortega: Ràdio
Jou Paret Iranzo: Nina bebé
Ernest Montià Llauradó: Torró,Televisor,Guerrer amb espasa,Calendari,Tren
Joan Josep Mallafré Gasull: Escacs,Cotxe,Llibreta,Conillet rosa,Os de peluix
Didac Guevara Mínguez: Ulleres de sol,Bossa de mà,Disc de música,Tren
Filomenu Not Lozano: Colònia,Jaqueta,Retallable,Sabates,Biberó,Torró
Max Jornet Mayans: Escacs
Sònia Ingla Pairó: Escacs,Bossa de mà,Guants,Gorro,Arc i fletxes
Paco Guixà Viu: Disc de música,Jersei,Cowboy
Angela Paula Llorens: Bossa de mà,Arc i fletxes
David Icart Llorente: Llapissos,Colònia,Conillet rosa,Arc i fletxes,Gorro,Torró
Bernarda Guevara Mont: Mitxons,Sabons,Nina morena,Manta,Cowboy
Alfred Lara Bonaterra: Mocador de coll,Guants,Os de peluix,Casa de nines
Joan Josep Linares Alcoberro: Capsa de bombons,Guerrer amb espasa,Guants,Sabates,Mitxons
Maria Lluisa Terrats Sabater: Televisor,Gorro,Bossa de mà,Cadireta
Manel Marsà Morral: Bossa de mà,Espasa de fusta,Bicicleta,Nina bebé,Conillet rosa,Capsa de bombons
Jou Iranzo Marot: Llapissos
Joanot Molas Majós: Bossa de mà,Espasa de fusta
Víctor Perez Roure: Arc i fletxes,Casa de nines
Didac  Lozano: Ulleres de sol,Disc de música,Joc de taula
Cristian Not Mínguez: Rellotge,Cotxe elèctric,Jaqueta,Corbata,Guants,Capsa de bombons
Cristian Codina Pedreño: Llibre,Llapissos
Frances Leal Mercadal: Os de peluix,Colònia,Calendari,Sabates,Casa de nines
Pepa Marsany Lozano: Rellotge,Biberó
Diego Giménez Maruny: Puzzle,Capsa de bombons,Biberó
Mònica Monné Paret: Mocador de coll,Guerrer amb espasa,Ordinador,Espasa de fusta,Arc i fletxes
Filomenu Sabater Mascarell: Arc i fletxes,Gorro,Biberó,Mitjons,Bicicleta
Sam Jaques Jorba: Retallable
Helena Maginet Marcó: Llibre,Guants
Víctor Ortiz March: Biberó,Corbata,Cowboy,Casa de nines,Cadireta,Bufanda
Joan Josep Terrats Miravet: Manta,Bossa de mà,Sabates,Calendari,Ulleres de sol,Jaqueta
Jou Puig Ortiz: Televisor,Sabons,Corbata,Espasa de fusta,Capsa de bombons,Cotxe
Rufo Rey Olivella: Televisor,Llapissos,Nina bebé,Conillet rosa,Cadireta,Os de peluix
Josep Jiménez Gasull: Colònia,Guerrer amb espasa,Ordinador,Cowboy
Baldiri Malé Jové: Puzzle,Os de peluix
Maria Marti Margalef: Gorro,Jaqueta,Cadireta
Josep Vives Lara: Biberó,Manta,Mocador de coll,Sabates,Calendari,Arc i fletxes
Didac Boix Pi: Biberó,Cotxe elèctric,Calendari
Víctor Maruny Manent: Televisor,Biberó,Jaqueta,Cowboy,Mocador de coll,Arc i fletxes
Josep Gasull Ingla: Mocador de coll,Colònia,Llibreta
Maria Llenas Murga: Bossa de mà,Rellotge
David Manyé Miravet: Mòbil,Caramels,Espasa de fusta,Ràdio
Candela Morillo Alemany: Torró,Biberó,Guants,Bicicleta
Homer Palop Pellicer: Mòbil,Mitxons,Cotxe,Mocador de coll
Joan Raga Lladó: Capsa de bombons,Guerrer amb espasa,Jaqueta,Sabates
David Jordana Llesera: Mitxons,Sabons,Colònia,Manta,Cotxe elèctric
Quim Piferrer López: Guerrer amb espasa
Jou Palau Laborda: Llibre,Colònia,Biberó,Cowboy
Gerard Gasull Guixà: Televisor,Sabons,Guerrer amb espasa
Homer Pijoan Malla: Manta
Marta Llauradó Masachs: Sabons,Llibreta,Ordinador,Arc i fletxes
Fe Oliva Mayans: Llapissos,Puzzle,Sabons
Pere Bru Pont: Corbata
Baldiri Viu Roure: Llapissos,Colònia,Corbata,Joc de taula,Ulleres de sol
Pepa Pou Maginet: Caramels,Torró,Jersei,Cotxe,Casa de nines
Mireia Matamala Maymó: Bufanda,Capsa de bombons,Biberó,Tren,Cowboy
Pepa Guilella Mínguez: Ràdio,Ordinador,Arc i fletxes
Filomenu Junyent Palacios: Ràdio
Bernarda Jodar Icart: Galetes,Biberó,Guants,Disc de música,Cowboy
Pepa Albiol Llatser: Manta,Guants,Estoig,Sabates
Gerard Ortega Marti: Puzzle,Nina morena,Mitjons,Espasa de fusta,Corbata
Maria Guevara Llucià: Jaqueta
Manel Llorente Guixà: Cotxe elèctric,Arc i fletxes
Queralt Pey Linares: Retallable,Nina morena,Os de peluix,Arc i fletxes
Filomenu Moya Armengol: Puzzle,Corbata,Cowboy
Met Marcu Cardona: Rellotge,Puzzle,Mitjons,Bicicleta,Caramels,Os de peluix
Felicitat Isern Iglesias: Televisor,Torró,Corbata
Cristian Malé Morral: Tren,Bossa de mà,Mitjons,Sabates,Nina morena,Ulleres de sol
Paco Paladell Margalef: Retallable,Llibre
Marta Cardona Aubert: Ràdio
Joanot Medrano Oveja: Sabons
Cesc Montià Pesarrodona: Sabates,Casa de nines
Iu Maginet Leal: Ulleres de sol,Disc de música,Sabates,Llapissos
Joan Ortiz Moron: Cotxe elèctric,Mitjons,Os de peluix
Iu Petit Marcu: Sabons,Corbata,Espasa de fusta,Bicicleta,Bufanda,Capsa de bombons
Merce Palau Lara: Llibre
Candela Paladell Hernández: Mocador de coll
Merce Serra Marlés: Llapissos,Estoig
Maria Mercadé Llobet: Sabates,Casa de nines
Paco Rodríguez Manent: Llibreta,Gorro,Capsa de bombons,Escacs,Sabates
Maria Lluisa Petrus Llofriu: Mocador de coll,Llibreta,Calendari,Mitxons
David Mitjavila Morillo: Retallable,Bossa de mà,Biberó,Cowboy
Jesus Pia Ortega: Colònia
Miquel Guevara Palacios: Mitxons
Pepa Marsà Junyent: Corbata
Quim Bru Maginet: Gorro,Joc de taula,Os de peluix,Cowboy
Toni Palau Guirao: Escacs,Sabons,Manta,Tren
Frederic Morral Malla: Escacs,Mòbil,Manta,Arc i fletxes
Joan Jové Matamala: Biberó,Tren,Jersei,Bicicleta,Cadireta,Ulleres de sol
Mireia Orobitg Cardona: Llibre,Bossa de mà,Puzzle,Ràdio,Calendari,Cadireta
Bernat Gual Piferrer: Joc de taula,Cadireta
Josep Masvidal Ordeig: Retallable,Ulleres de sol,Os de peluix,Mòbil
Toni Llucià Pujol: Llibre,Televisor,Calendari,Jersei,Ulleres de sol
Homer Jiménez Messegué: Rellotge,Nina morena,Ràdio
Josep Antoni Albí Ubach: Llibre
Joanot Paula Sabater: Tren
Merce Guirao Murga: Mocador de coll,Jaqueta,Joc de taula
Helena Messegué Oliveras: Jersei
Joanot Albí Roure: Mòbil,Sabates
Lluis Mont Jiménez: Ulleres de sol,Colònia,Nina rossa,Os de peluix,Casa de nines
Pitu Taberner Ortiz: Arc i fletxes,Llibreta,Cadireta
Merce Llatser Oliva: Bossa de mà,Conillet rosa,Arc i fletxes
Maria Lluisa Guvern Marlés: Nina rossa,Joc de taula
Angela Llatser Soler: Colònia,Arc i fletxes
Pepa Mínguez Pujol: Arc i fletxes
Diego Montràs Masmitjà: Bufanda,Ulleres de sol,Escacs,Disc de música,Jersei
Susanna Messegué Parra: Ràdio,Ulleres de sol,Caramels,Cadireta,Arc i fletxes
Pepa Paradís Masclans: Rellotge,Manta,Jersei
Jou Llauradó Agulla: Cotxe elèctric
Diego Raga Mont: Rellotge,Cotxe
Frances Leal Llobet: Torró
Met Hosta Bonastre: Retallable,Mocador de coll,Espasa de fusta
Joan Molas Paradís: Mocador de coll,Caramels,Estoig,Calendari
Mònica Montràs Matute: Llapissos,Caramels,Joc de taula,Rellotge,Cotxe
Cesc Jordana Guilella: Llibre,Mòbil,Conillet rosa
Fe Ibarra Hom: Mitxons,Mòbil,Biberó,Nina morena,Arc i fletxes
Jou Rodríguez Rey: Mitxons,Mitjons
Joan Josep Marata Pinyas: Guants,Nina rossa,Joc de taula,Arc i fletxes
Gerard Hosta Olivella: Televisor,Nina bebé,Sabons,Guants,Conillet rosa
Mònica Pia Ibarra: Galetes,Colònia,Llibreta,Ordinador,Nina rossa
Sònia Pesarrodona Serra: Corbata
Alfred Laborda Guixà: Jaqueta,Sabates
Angela Isanta Taberner: Televisor,Bufanda,Guerrer amb espasa,Corbata,Nina morena
Cristian Marcu Malla: Llapissos,Nina morena,Mòbil,Llibreta,Casa de nines
Enric Manent Gasull: Galetes,Os de peluix,Ràdio
Filomenu Mayné Petrus: Calendari,Tren
Queralt Pey Matamala: Sabons
Mònica Margalef Gutierrez: Llibreta,Jaqueta
Joan Pallarol Paladell: Torró,Corbata,Estoig,Conillet rosa,Capsa de bombons,Ordinador
Bernat Just Ubach: Mitjons,Nina rossa,Cowboy
Queralt Padilla Juanola: Sabons,Torró,Jaqueta,Colònia,Guerrer amb espasa
Gerard Guardiola Marqués: Cotxe elèctric
Joan Iranzo Pey: Bufanda,Sabons,Llibreta,Nina morena,Estoig
Jesus Jodar Latre: Bossa de mà,Llibreta,Corbata
Xavier Pedreño Lozano: Llapissos,Biberó,Cowboy,Mitxons,Sabates,Cadireta
Joan Josep Jara Mascarell: Gorro,Mitjons
Gerard Jodar Masana: Cotxe elèctric,Espasa de fusta,Nina rossa,Sabates
Jou Murga Mayné: Capsa de bombons,Nina rossa,Casa de nines
Joan Josep Monné Padilla: Colònia,Manta,Calendari,Cotxe elèctric,Arc i fletxes
Iu Paret Pinyas: Tren,Casa de nines
Max Mans Marcet: Nina bebé,Espasa de fusta,Cotxe
Aina Navajas Mancho: Rellotge,Puzzle,Disc de música,Estoig
Iu Ortiz Giménez: Escacs,Calendari,Arc i fletxes
Queralt Malla Llatser: Bossa de mà,Cotxe elèctric,Disc de música
Charly Marqués Masclans: Jaqueta
Aina Mont Alcoberro: Guants,Cowboy
Magda Aubert Padrosa: Bufanda,Colònia,Joc de taula,Casa de nines
Candela Palau Peret: Guerrer amb espasa,Sabates,Ràdio,Galetes,Llibreta,Disc de música
Candela Guevara Vives: Llibre,Mòbil,Arc i fletxes,Manta,Tren
Pitu Llabot Leal: Llibre,Retallable,Jaqueta,Cotxe
Alfons Ibarra Pallarol: Ulleres de sol,Llibreta,Corbata
Marta Navajas Vives: Colònia,Cotxe elèctric,Guants
Joan Fernàndez Armengol: Televisor,Caramels,Biberó,Casa de nines,Conillet rosa,Os de peluix
Carles Navajas Marti: Retallable,Llapissos,Capsa de bombons,Sabates
Joan Moragues Palau: Capsa de bombons,Corbata,Puzzle,Guants,Sabates,Llibreta
Carles Padrosa Mallafré: Arc i fletxes
Pepa Jara Lladó: Televisor
Josep Antoni Masdefiol Lara: Nina bebé,Cowboy,Arc i fletxes,Tren,Casa de nines
Josep Negre Lara: Bossa de mà
Josep Antoni Vilamoll Brunyol: Bossa de mà,Puzzle,Guerrer amb espasa,Jersei,Espasa de fusta,Disc de música
Gerard Just Marín: Bossa de mà,Puzzle
Sònia Jara Luque: Llapissos,Mòbil,Nina rossa,Arc i fletxes
Víctor Macrané Rey: Bossa de mà,Colònia,Os de peluix,Conillet rosa
Paco Perez Jové: Mòbil,Sabons,Guants,Cotxe,Arc i fletxes
Sam Padilla González: Galetes,Retallable,Arc i fletxes,Jersei,Cadireta
Marti Padilla Manyé: Llibre,Jaqueta,Bicicleta
Queralt Ibarra Marsà: Llapissos,Llibreta
Jou Jiménez Guasch: Mitxons,Tren,Ordinador,Sabates,Bicicleta
Alfred Jorba Masdevall: Escacs,Capsa de bombons,Cotxe
Xavier Malé Gual: Gorro,Biberó
Alfons Llorente Petit: Sabons,Capsa de bombons,Guants,Casa de nines
Frederic Macià Llort: Galetes
Pepa Ruiz Maldonado: Sabons,Os de peluix,Tren
Josep Llansana Ricart: Llibre,Llapissos,Mitxons
Joan Laborda Oveja: Llibreta,Cotxe,Espasa de fusta
Bernarda Maldonado Miravet: Llapissos,Mitxons,Sabates,Jersei,Bufanda,Llibreta
Sònia Llobet Manyé: Mitxons,Disc de música
Felicitat Guixà Perez: Capsa de bombons,Colònia,Biberó,Ordinador
Xavier Guardiola Juncosa: Ulleres de sol,Colònia,Cotxe elèctric,Llapissos,Bicicleta
Maria Marcos Julià: Biberó
Joanot Matarodona Jodar: Caramels,Guerrer amb espasa,Jaqueta,Sabates
Frederic Mascarell Serra: Mocador de coll,Nina morena,Nina rossa
Xavier Llanet Guilella: Televisor,Nina bebé,Guerrer amb espasa,Conillet rosa,Tren
Aina González Brunyol: Puzzle,Jersei,Os de peluix
Xavier Jaques Petrus: Puzzle,Mitjons,Espasa de fusta,Nina rossa,Ordinador,Os de peluix
Joan Marsà Margalef: Estoig
Josep Messegué Ruiz: Guerrer amb espasa,Cotxe elèctric
Òscar Llucià Ricart: Caramels,Sabons,Sabates
Gerard Jorquera Sabater: Torró
Quim Llort Palomera: Arc i fletxes
Joan Paradís Oliveras: Torró,Manta,Ordinador,Conillet rosa,Biberó
Joan Josep Hosta Monné: Colònia,Biberó,Espasa de fusta
Sònia Marsany Ibarra: Caramels,Llibreta,Corbata,Cowboy,Escacs,Capsa de bombons
Bernat Mayans Malé: Mocador de coll,Torró,Estoig,Conillet rosa,Cowboy
Queralt Masana Malé: Retallable,Nina bebé,Jaqueta
Paco Leal Manyé: Guerrer amb espasa,Joc de taula
Miquel Puig Palau: Gorro,Mòbil,Sabons,Corbata,Nina rossa
Angela Paraire Malla: Cadireta
Joan Alcoberro Manent: Llibre,Puzzle
Candela Martell Paladell: Televisor
Mireia Pedreño Pont: Televisor,Bossa de mà,Colònia,Sabates
Angela Morillo Olivella: Escacs,Manta,Calendari
Mireia Isanta Marata: Tren,Mocador de coll,Guants,Nina rossa,Ordinador,Os de peluix
Antonia Marti Padilla: Televisor,Rellotge,Cowboy
Diego Marqués Páramo: Nina morena
Max Ruiz Brau: Televisor,Mitxons,Espasa de fusta,Cotxe,Arc i fletxes
Diego Hernández Juvany: Escacs,Retallable,Caramels,Jersei,Mòbil
Toni Ortiz Morral: Televisor,Manta,Corbata,Bicicleta,Cadireta,Ordinador
Daniel Manzano Mata: Nina bebé,Llibreta,Mòbil,Sabates,Casa de nines
Cesc Alcoberro Malla: Bufanda,Nina bebé,Nina morena,Jersei,Calendari
Queralt Pinyas Pallejà: Bossa de mà,Rellotge,Capsa de bombons,Sabates
Sònia Rey Palau: Galetes
Joan Padilla Juanola: Llibre,Caramels,Mòbil,Guerrer amb espasa,Sabons,Cotxe
Mònica Lara Oliva: Llapissos,Bicicleta
Maria Lluisa Lluch Marcos: Colònia,Torró,Cotxe,Espasa de fusta
Xavier Guvern Llansana: Sabons,Bicicleta
Zeus Paladell Codina: Nina bebé,Mitxons,Ordinador,Llibreta,Biberó
Gerard Padrosa Marcos: Televisor,Puzzle,Capsa de bombons,Joc de taula
Didac Palop Mercadal: Retallable,Nina morena,Disc de música
Alfons Marcu Mínguez: Galetes,Mocador de coll,Llibreta
Iu Piqueras Brau: Ràdio
Miquel Pallarol Matarodona: Gorro,Os de peluix
Mònica Alemany Iranzo: Casa de nines,Colònia,Torró,Sabates,Cowboy
Josep Masachs Pesarrodona: Mòbil,Llibreta,Nina rossa,Espasa de fusta,Bicicleta
Josep Alcoberro Ortiz: Caramels,Biberó,Ordinador,Tren,Arc i fletxes
Queralt Paradís Ordeig: Sabates
Bernarda Ordeig Pelayo: Gorro,Escacs,Mitxons,Os de peluix,Arc i fletxes
Joan Josep Just Lara: Sabons,Cadireta
Joanot Orobitg Maginet: Retallable,Cowboy
Pepa Leal Armengol: Retallable,Nina bebé,Manta
Enric Gutierrez Parer: Mitxons,Joc de taula,Casa de nines
Enric Pitarch Guimerà: Galetes,Ulleres de sol
Queralt Mont Palau: Cowboy
Queralt Masclans Iglesias: Nina bebé,Ràdio
Pere Pia Juanola: Televisor,Mòbil,Llibreta,Escacs,Gorro
Marta Maymó Piñol: Llibreta,Jaqueta,Calendari
Jesus Mascarell Llabot: Ràdio
Pitu Isanta Mallafré: Galetes,Sabons,Jaqueta,Joc de taula,Casa de nines
Marta Albí Jordana: Mocador de coll,Cowboy
Anna Orobitg Marsà: Torró,Cotxe elèctric
Maria Mula Llanet: Bossa de mà,Mitxons,Manta,Corbata,Cowboy
David Just Orobitg: Jaqueta,Cadireta
Homer Mata Orobitg: Torró,Jaqueta,Corbata,Tren
Aina Marín Luque: Guerrer amb espasa,Mitjons
Queralt Llabot Marcu: Gorro,Bicicleta,Colònia,Cotxe,Tren
Iu Juvany Roure: Guerrer amb espasa,Bicicleta
Aina Alcoberro Pallarol: Galetes,Escacs,Arc i fletxes,Os de peluix,Ràdio
Rufo Medina Llanet: Caramels,Nina morena,Rellotge,Cowboy
Víctor Pinot Guvern: Mòbil,Joc de taula
Max Palau Pastoret: Calendari,Jersei,Cotxe,Tren
Helena Bonaterra Boix: Ulleres de sol
Toni Mascarell Mercadal: Llapissos,Rellotge,Sabates,Bicicleta,Cadireta,Disc de música
Frances Llorente Miravet: Retallable,Bufanda,Torró,Espasa de fusta,Sabates
Mireia Gutierrez Piqueras: Mitxons,Ordinador,Cotxe,Tren
Sergi Llorens Llabot: Bossa de mà,Colònia,Sabates
Bernarda Maluquer Majós: Televisor,Tren,Puzzle,Jersei,Ràdio,Cadireta
Filomenu Julià Pallejà: Mocador de coll
Queralt Oveja Aubert: Galetes,Llapissos,Sabates,Jersei
Antonia Molas Ibarra: Televisor,Gorro,Guants,Ulleres de sol,Ràdio
Sam Palop Brunyol: Caramels,Casa de nines,Joc de taula,Espasa de fusta,Bufanda,Colònia
Miquel Masclans Fernàndez: Guerrer amb espasa
Quim Marcó Ubach: Llibreta,Sabates,Bicicleta
Diego Pedrol Manyé: Gorro
Maria Lluisa Palomera Cardona: Ulleres de sol,Manta,Disc de música,Sabates,Mocador de coll
Marta Marcu Hosta: Retallable,Sabons,Conillet rosa
Susanna Masdevall Pedreño: Escacs,Ulleres de sol,Colònia,Disc de música,Ordinador
Merce Messegué Albí: Cotxe elèctric,Mitjons,Jersei
Queralt Casajuana Hom: Estoig,Mitxons,Arc i fletxes,Sabates,Ràdio
Max Morral Parer: Llapissos,Sabons,Cowboy,Mòbil,Sabates,Arc i fletxes
Pere Lluch Oveja: Puzzle,Cotxe
Charly Llabot Armengol: Llapissos,Mitxons,Nina rossa,Calendari,Casa de nines
Bernarda Marín Palacios: Sabons,Corbata,Tren,Mitjons,Llibreta,Ordinador
Magda Hernández Magrinyà: Joc de taula
Magda Paraire Masachs: Espasa de fusta
Cristian Ortega Macià: Ulleres de sol,Calendari,Sabates,Tren
Sergi Roure Llenas: Ordinador,Joc de taula
Manel Magrinyà Orobitg: Mocador de coll,Cotxe
Cesc Olivella Roure: Llapissos,Mitxons,Jersei,Ràdio,Gorro,Ordinador
Pitu Maluquer Paula: Puzzle,Llibreta,Cotxe elèctric,Jersei
Xavier Mitjavila Jornet: Bufanda
Maria Lluisa Mula Mallafré: Mòbil,Corbata,Sabates
Josep Montroig Llansana: Nina morena,Corbata,Os de peluix,Estoig
Pep Llorens Miravet: Llibre,Rellotge,Tren,Cowboy,Bufanda,Torró
Marti Munné Guevara: Gorro,Mòbil,Ràdio
Manel Pascal Montió: Biberó
Diego Jara Oliveras: Cotxe,Jersei,Ordinador,Joc de taula
Pep Morillo Parer: Escacs,Bossa de mà,Capsa de bombons
Charly Matamala Gasull: Llapissos
Met Casajuana Leal: Manta,Guerrer amb espasa,Sabates,Ràdio,Jersei,Ordinador
Ot Boix Alba: Gorro,Nina morena
Joan Josep Guasch Viu: Estoig,Sabates,Mitjons,Calendari,Galetes,Ulleres de sol
Lluis Mercadal Mercadal: Tren
Sam Lacalle Mercadé: Calendari,Corbata,Joc de taula,Bicicleta
Marti Ortiz Taberner: Puzzle,Corbata
Sergi Masvidal Morral: Mocador de coll,Corbata
Bernarda Mayné Páramo: Puzzle,Sabons,Nina rossa
Magda Llorens Llenas: Corbata,Tren,Retallable,Guerrer amb espasa,Jersei,Colònia
Helena Lozano Viu: Torró,Sabons,Biberó,Jersei,Bicicleta
Susanna Pedreño Isanta: Guants,Espasa de fusta
Met Masllorens Guardiola: Puzzle
Maria Lluisa Armengol Isern: Manta,Nina rossa
Pol Jorquera Matarodona: Puzzle,Capsa de bombons,Conillet rosa,Guerrer amb espasa
Frances Masdefiol Maginet: Espasa de fusta
Pol Miravet Puig: Casa de nines,Os de peluix,Cadireta
Gerard Navajas Medrano: Gorro,Ràdio,Guants,Sabates,Tren
Carles Mach Marcet: Estoig,Manta,Sabates,Joc de taula,Tren
Òscar Albí Marata: Llibre,Mòbil,Televisor,Nina morena,Sabates
Helena Platja Jaques: Escacs,Cotxe elèctric,Tren
Jesus Taberner Murga: Televisor,Capsa de bombons,Guerrer amb espasa,Sabates,Conillet rosa
Frances Vilamoll Paraire: Cadireta
Jean Pesarrodona Pellicer: Rellotge,Caramels,Casa de nines,Mitjons,Arc i fletxes,Torró
Candela Sonet Malla: Casa de nines,Capsa de bombons,Nina rossa,Jersei,Corbata
Aina Mata March: Llapissos,Conillet rosa,Sabates,Cowboy
Manel Hosta Mallafré: Nina morena,Corbata,Llibreta
Didac  Marín: Puzzle,Torró,Jaqueta,Disc de música
Carles Negre Perez: Sabons,Guerrer amb espasa,Nina rossa,Cowboy
Queralt Guirao Montràs: Llibreta,Jaqueta,Nina rossa,Sabates,Cadireta
Max Monells Moron: Tren
Cesc Mercadal Albiol: Nina bebé,Colònia,Tren
Met Pesarrodona Soler: Mocador de coll,Tren,Ràdio
Frederic Marcos Jaques: Televisor,Mitxons,Ordinador,Nina rossa,Cotxe elèctric,Disc de música
Jesus Pinot Macrané: Galetes,Mòbil,Llibreta,Joc de taula,Cotxe
David Pelayo Mercadé: Escacs,Gorro,Manta,Calendari
Merce Iglesias Mínguez: Bufanda,Escacs,Mitxons,Mocador de coll
Magda Mont Agulla: Llapissos,Rellotge,Mitjons,Cadireta,Ordinador,Cotxe
Fe Aubert Piñol: Torró,Llibreta,Conillet rosa,Jersei,Ràdio
Candela Bru Oveja: Corbata,Casa de nines,Puzzle,Sabates,Nina rossa,Capsa de bombons
Jean Llach Montràs: Ordinador,Jersei,Cowboy
Lluis Llach Huguet: Rellotge,Disc de música,Conillet rosa
Pitu Masllorens Picanyol: Mòbil,Bicicleta,Ràdio
Joan Josep Llauradó Juvany: Retallable,Sabons,Manta,Os de peluix
Maria Roure Murga: Guerrer amb espasa,Conillet rosa,Mitxons,Biberó,Calendari,Escacs
Bernarda Parer Marata: Rellotge,Cowboy,Mòbil,Gorro,Llibreta,Os de peluix
Joanot Mata Medina: Nina bebé,Rellotge,Tren
Cristian Juncosa Vives: Nina bebé,Manta,Jersei,Ulleres de sol
Filomenu Maldonado Marlés: Mocador de coll,Cotxe elèctric,Llapissos
Cristian Paradís Paradís: Jaqueta,Sabates,Casa de nines
Víctor Masdevall Medina: Bufanda
Paco Morillo Pujol: Corbata,Bossa de mà,Mitjons,Espasa de fusta,Ràdio,Os de peluix
Cesc Maurell Ubach: Mitxons,Estoig,Espasa de fusta,Bicicleta
Frances Giménez Pesarrodona: Torró,Retallable,Nina morena,Bicicleta
Pere Marcó Monné: Mitjons
Anna Llofriu Marot: Bossa de mà,Caramels,Corbata,Conillet rosa,Ulleres de sol
Josep Antoni Masdevall Jaques: Rellotge,Conillet rosa,Cowboy
Marti Gasull Cardona: Conillet rosa
Aina Llenas Montràs: Galetes,Gorro,Escacs,Ordinador,Tren
Jean Masllorens Just: Televisor,Manta,Tren,Espasa de fusta,Escacs,Capsa de bombons
Queralt Macrané López: Guerrer amb espasa,Corbata
Joan Josep Pellicer Linares: Retallable,Disc de música,Jersei,Cowboy
Iu Peret Piñol: Torró
Jean Medrano Manent: Llapissos,Caramels,Sabates
Charly Raga Palau: Guerrer amb espasa
Mònica Medrano Mayans: Ulleres de sol,Casa de nines,Cowboy
Cesc Matamala Llansana: Bossa de mà,Manta,Ordinador,Nina rossa,Tren
Aina Oliva Pitarch: Torró
Pere Lladó Maurell: Rellotge,Llibreta,Ordinador,Estoig,Arc i fletxes
Cesc  Masachs: Mocador de coll
Joan Munné Paladell: Manta,Jaqueta,Joc de taula
Josep Antoni Pinyas Paraire: Mòbil,Llibreta,Sabates,Arc i fletxes
Manel Llansana Montià: Cadireta
Pep Gual Paladell: Llibre,Guerrer amb espasa,Capsa de bombons,Puzzle
Jou Hom Bru: Espasa de fusta
Jean Soler Masclans: Escacs,Torró,Guants,Espasa de fusta,Cowboy
Angela Ibarra Visent: Manta,Rellotge,Cotxe elèctric,Guants
Didac Llorente Mallafré: Sabons,Nina morena,Sabates,Cowboy
Maria Masdefiol Mascarell: Guerrer amb espasa,Jaqueta
Víctor Lacalle Orobitg: Llibre,Cowboy,Jaqueta,Calendari,Arc i fletxes
Joanot Llansana Manyé: Bufanda,Biberó,Espasa de fusta,Sabates,Nina morena
Toni Montió Fernàndez: Bufanda,Puzzle,Rellotge,Sabates,Cadireta
Daniel Iglesias Mercadal: Corbata,Mocador de coll,Puzzle,Bicicleta,Arc i fletxes,Os de peluix
Sam Masllorens Moya: Galetes,Llapissos,Conillet rosa,Nina bebé
Homer Bru Pelegrí: Bufanda,Bossa de mà,Ulleres de sol,Arc i fletxes
Fe Palop Pujol: Gorro,Llapissos,Nina rossa,Cadireta
Paco Rodríguez Alcoberro: Sabates,Ordinador,Cotxe,Bicicleta
Charly Cardona Pitarch: Corbata,Cowboy,Conillet rosa,Arc i fletxes,Llibreta,Ordinador
Fe Oliva Alcoberro: Bufanda,Guerrer amb espasa,Estoig,Calendari,Arc i fletxes
Òscar Murga González: Escacs,Llapissos,Ordinador
Gerard Macrané Mans: Espasa de fusta
Pepa Moragues Llenas: Retallable,Ulleres de sol,Llibreta,Estoig,Tren
Anna Piñol Martell: Llapissos,Cadireta,Sabates,Casa de nines
Daniel Ruiz Llorens: Llapissos,Guerrer amb espasa,Corbata
Carles Masllorens Iglesias: Escacs,Llibre,Llibreta,Guants
Homer Morral Pitarch: Escacs,Caramels,Rellotge,Bicicleta
Joan Morillo Julià: Cowboy,Joc de taula,Calendari,Gorro,Ulleres de sol,Capsa de bombons
Mireia Paret Llanet: Ràdio,Llibreta,Tren
Homer Terrats Petrus: Bufanda,Bossa de mà,Llibreta,Jersei
Antonia Paladell Hom: Llibre,Manta,Bossa de mà,Guerrer amb espasa,Guants,Nina rossa
Angela Agulla Aubert: Nina bebé,Cotxe
Felicitat Hosta Iranzo: Bicicleta,Retallable,Ràdio,Llibreta,Disc de música,Cotxe
Iu Pallarol Julià: Puzzle,Nina morena
Bernat Majós Cardona: Llibreta,Manta,Corbata,Joc de taula,Arc i fletxes
Jean Ruiz Tubau: Os de peluix,Bicicleta
Xavier Molas Pijoan: Televisor
Bernat Marsà Jara: Guerrer amb espasa,Guants,Mitjons,Nina rossa
Víctor Masdefiol Pericas: Llibre,Mòbil,Llibreta,Disc de música,Cotxe
Angela Mínguez López: Galetes,Gorro,Corbata,Espasa de fusta,Ràdio
Enric Palau Nogué: Espasa de fusta,Jaqueta,Ordinador,Sabates,Cadireta
Pol Pitarch Linares: Caramels,Biberó,Cotxe
Gerard Taberner Agulla: Torró
Alfons Pallejà Guilella: Mocador de coll,Casa de nines
Josep Antoni Martell Morral: Rellotge,Nina rossa,Bicicleta
Miquel Margalef Gasull: Ulleres de sol
Xavier Llansana Brunyol: Sabons,Sabates
Josep Antoni Lacalle Juncosa: Bufanda,Cotxe elèctric,Os de peluix
Sergi Lloris Masolivé: Mòbil,Guerrer amb espasa,Jersei,Cotxe elèctric,Sabates
Sam Pont Paret: Escacs,Rellotge,Ordinador,Sabates
Ot Sabater Piñol: Nina bebé,Guants,Tren
Maria Lluisa Paradís Pey: Puzzle,Mitxons,Estoig,Mitjons,Llibreta,Ordinador
Xavier Latre Molas: Escacs,Mòbil,Capsa de bombons,Sabates,Ràdio
Susanna Matute Just: Mòbil,Tren,Corbata,Nina rossa,Cadireta
Joaquim Boix Macrané: Mòbil,Rellotge,Sabates
Quim Pujol Pelegrí: Disc de música,Joc de taula
Max Maluquer Mont: Guants,Os de peluix
Ernest Llatser Jaques: Cotxe elèctric
Felicitat Fernàndez Llabot: Guerrer amb espasa,Calendari,Joc de taula
Jesus Molas Llucià: Galetes,Nina bebé,Conillet rosa
Jou Masdevall Manyé: Cowboy
Quim Hernández Mallafré: Ràdio,Arc i fletxes
Frances Llofriu Gual: Televisor,Mòbil,Sabons,Cowboy
David Sabater Pallarol: Caramels,Llibreta,Nina morena,Bicicleta
Angela Llorente Manent: Televisor,Estoig,Ràdio
Magda Lozano Matamala: Manta,Puzzle,Nina rossa,Arc i fletxes,Gorro,Ulleres de sol
Anna Sabater Manzano: Mocador de coll,Espasa de fusta,Bicicleta,Escacs,Ulleres de sol,Disc de música
Maria Lluisa Vilamoll Lloris: Os de peluix,Cotxe elèctric,Ordinador,Nina rossa,Mitjons
Iu Molas Leal: Rellotge
Didac Páramo Magrinyà: Sabons,Jaqueta,Cowboy
Marti Jaques Jorba: Bufanda,Nina morena
Cristian Perez Pairó: Cowboy,Ordinador,Joc de taula,Bicicleta
Helena Navajas Malé: Sabons,Guants
Bernarda Pujol Morral: Gorro,Llapissos,Mitxons,Televisor,Bossa de mà
Pol Peret Paret: Bufanda,Bossa de mà,Guants,Espasa de fusta
Marta Ruiz Pelegrí: Rellotge,Torró,Calendari
Sònia Sabater Marata: Mocador de coll,Colònia,Sabates,Bicicleta
Joanot Viu Margalef: Guerrer amb espasa,Estoig
Gerard Mayans Llofriu: Retallable,Nina bebé,Estoig,Joc de taula,Ordinador
Marta  Masmitjà: Escacs,Guerrer amb espasa,Espasa de fusta
Cristian Laborda Lozano: Biberó,Guants,Estoig,Conillet rosa
Daniel Palomera Piñol: Bossa de mà
Angela Guixà Ordeig: Bossa de mà,Guerrer amb espasa,Estoig,Calendari
Pitu Messegué Moron: Caramels,Capsa de bombons,Jaqueta,Jersei,Cotxe
Frances Ibarra Masllorens: Espasa de fusta,Jersei
Charly Negre Llatser: Guerrer amb espasa,Capsa de bombons,Jaqueta,Llibreta
Joan Macrané Montràs: Bufanda,Puzzle,Jaqueta,Cotxe,Arc i fletxes
Xavier Palomera Monné: Llapissos,Caramels,Jersei,Nina rossa,Joc de taula
Enric Lluch Medrano: Retallable,Ulleres de sol,Mitxons,Espasa de fusta,Tren
Rufo Pujol Pinyas: Llapissos,Guerrer amb espasa
Miquel Ortega : Guants,Jersei
Lluis Magrinyà Pia: Mocador de coll,Joc de taula,Cowboy
Didac Taberner Pey: Caramels,Capsa de bombons,Guerrer amb espasa
Charly Huguet Solé: Casa de nines
Daniel Pesarrodona Marcos: Sabates,Capsa de bombons,Espasa de fusta,Mitjons,Conillet rosa
Felicitat Piñol Sabater: Nina rossa
Filomenu Serra Fernàndez: Caramels,Jersei
Alfons Maruny Maruny: Rellotge,Jaqueta
Max Jodar Pou: Bossa de mà,Puzzle,Corbata,Espasa de fusta,Llapissos
Frances Mula Huguet: Televisor,Joc de taula,Nina rossa
Iu Maluquer Margalef: Bufanda,Guerrer amb espasa,Calendari,Joc de taula,Casa de nines
Maria Lluisa Pedrol Alemany: Jersei
Toni Solé Mínguez: Llapissos,Colònia,Joc de taula,Cotxe,Disc de música
Joanot Llabot Vinals: Ulleres de sol,Capsa de bombons,Estoig,Sabates,Ràdio
Maria Lluisa Paladell Jodar: Cotxe elèctric,Corbata
Aina Llach March: Mòbil
Iu Soler Maurell: Guerrer amb espasa,Cotxe
Baldiri Piñol Pelayo: Caramels,Joc de taula
Pere Manent Mancho: Televisor,Manta,Bicicleta,Conillet rosa,Bufanda,Disc de música
Enric Pou Pastoret: Mòbil,Cotxe
Lluis Mula Codina: Joc de taula,Bicicleta,Sabates,Nina rossa,Escacs,Ordinador
Angela Mancho Moya: Capsa de bombons,Puzzle,Torró,Colònia,Llibreta
Met Matarodona Martell: Mòbil
Ot Ruiz Ubach: Gorro,Bufanda,Guants
Manel Marti Navajas: Sabates,Tren
Paco Pey Mata: Nina bebé,Rellotge,Colònia,Manta
Toni March Marlés: Joc de taula
Jesus Terrats Maurell: Retallable,Colònia,Llibreta
Marti Juncosa Guilella: Retallable,Disc de música,Joc de taula,Ordinador
Homer Nogué Pallarol: Mòbil,Caramels
Pere Giménez Ibarra: Cowboy
Aina Mundó Masana: Llibre,Disc de música
Candela Bonaterra Peret: Bufanda,Biberó
Cesc Guevara Gasull: Llibre,Capsa de bombons,Manta,Mitjons,Tren
Diego Messegué Sabater: Retallable,Nina bebé,Mitxons,Corbata
Angela Ruiz Jara: Biberó,Cowboy,Puzzle,Bicicleta,Conillet rosa,Galetes
Víctor Bru Iglesias: Mocador de coll,Mitxons,Torró,Bicicleta
Sergi Montió Picanyol: Nina bebé,Calendari,Sabates,Ordinador
Diego Macià Oliveras: Ulleres de sol
Òscar Marsà Picanyol: Nina rossa
Sònia Marcó Not: Jersei,Ràdio
Frederic Llorens Pey: Caramels,Calendari,Sabates
Ernest Magrinyà Jara: Capsa de bombons,Rellotge,Cotxe elèctric,Conillet rosa,Ràdio
Aina Albí Llorente: Jersei,Cadireta
Joanot Molas Maymó: Casa de nines
Joan Serra Puig: Joc de taula
Pep Nogué Pascal: Colònia
Paco Giménez Bonaterra: Cotxe,Sabons,Torró,Puzzle,Nina rossa
Filomenu Pelayo Jara: Jaqueta,Tren,Mòbil,Puzzle,Joc de taula,Jersei
Joan Josep Mancho Junyent: Mocador de coll,Guerrer amb espasa,Nina bebé
Zeus Lara Vives: Cotxe elèctric,Estoig,Disc de música
Charly Jodar Guilella: Televisor,Gorro
Susanna Llach Macià: Capsa de bombons,Jaqueta,Os de peluix
Pol Mont González: Mòbil,Capsa de bombons,Guants
Homer Fernàndez Piñol: Llapissos,Arc i fletxes,Os de peluix,Ràdio
Merce Moron Pericas: Bicicleta
Toni Hosta Malla: Tren,Cotxe elèctric,Nina rossa,Cadireta
Magda Maldonado Ortega: Retallable,Ulleres de sol,Cowboy,Espasa de fusta,Bufanda
Homer Piferrer Paula: Galetes,Llapissos,Nina bebé,Sabates,Bufanda
Pep Palomera Pinot: Ordinador
Quim González Monells: Puzzle,Espasa de fusta,Nina rossa,Sabates
Jou Malla Parer: Escacs
Max Agulla Llorens: Calendari,Sabates,Corbata
Marti Navajas Llorente: Rellotge
Marta Lloris Masolivé: Televisor,Cotxe elèctric,Guerrer amb espasa,Mitjons,Jersei,Llibreta
Josep Boix Codina: Colònia,Casa de nines
Frederic Lladó Parra: Sabates,Llibreta,Conillet rosa,Nina rossa
Queralt Mayné Picanyol: Televisor,Ulleres de sol,Puzzle
Joan Visent Parra: Escacs
Pere Guimerà Sabater: Cowboy
Frederic Hom Pinot: Ulleres de sol,Colònia,Nina morena,Guants,Joc de taula
Enric Soler Jiménez: Os de peluix
Lluis Messegué Giménez: Llibre
Joan Josep Viu Pinot: Retallable,Ràdio,Jaqueta,Os de peluix,Cadireta
Ot Marti Parer: Mòbil,Guerrer amb espasa,Cotxe elèctric,Jaqueta,Tren
Merce Raga Julià: Cadireta,Mitjons,Conillet rosa,Casa de nines
Jesus Oliveras Guilella: Llibre,Puzzle,Biberó,Rellotge,Mitjons
Cesc Mata Visent: Cowboy,Puzzle,Mitxons,Guants,Escacs,Ordinador
Sònia Maluquer Not: Televisor,Mocador de coll,Llibreta,Os de peluix,Bicicleta
Joan Pesarrodona Maluquer: Nina bebé,Guerrer amb espasa,Conillet rosa
Joaquim Marcet Agulla: Guants
Charly Juncosa Iranzo: Estoig
Òscar Munné Cardona: Puzzle,Colònia,Calendari
Iu Mitjavila Malé: Cadireta
Lluis Marcet Navajas: Galetes,Puzzle,Biberó
Daniel Masllorens Lluch: Gorro,Torró
Aina Mercadé Montià: Ulleres de sol,Rellotge,Estoig,Jersei
Pepa Lara Macià: Bicicleta,Ordinador,Cadireta
Joan Palomera Peret: Gorro,Mocador de coll,Disc de música,Cadireta
Sam Pinot Paradís: Conillet rosa
Diego Llorens Marot: Torró,Guerrer amb espasa,Joc de taula
Antonia Marcu Oliveras: Bossa de mà,Caramels,Cotxe,Nina rossa,Nina bebé
Lluis Llenas Bru: Gorro,Calendari
Marta Maruny Tió: Colònia,Llibreta,Estoig,Ràdio
Òscar Paradís Sabater: Biberó,Corbata,Casa de nines,Mitjons,Espasa de fusta,Calendari
Fe Bru Llanet: Bufanda,Galetes,Jaqueta,Estoig,Cotxe
Paco Pellicer Matarodona: Mocador de coll,Arc i fletxes,Tren
Merce Picanyol Lacalle: Corbata,Nina morena,Os de peluix,Espasa de fusta,Cowboy
Joanot Marín Guimerà: Biberó,Retallable,Guants,Mitjons,Cadireta,Os de peluix
Lluis Guilella Jornet: Escacs,Caramels
Enric Hosta Molas: Guerrer amb espasa,Mitxons,Os de peluix,Calendari
Quim Guixà Marsà: Torró,Manta,Arc i fletxes,Os de peluix,Bicicleta
Xavier Paladell Pia: Televisor,Manta,Conillet rosa,Ràdio
Josep Montroig Marata: Caramels,Conillet rosa,Mòbil,Calendari,Bufanda,Llibreta
Bernat Maluquer Pou: Cotxe,Cowboy
Alfons  Huguet: Rellotge,Ordinador,Puzzle,Tren
Ernest Ordeig Leal: Manta,Jaqueta,Disc de música
Carles Pascal Majós: Mitjons
Marta Pesarrodona Paradís: Galetes,Retallable
Maria Lluisa Montió Boix: Ordinador,Os de peluix,Casa de nines
Susanna Jaques Ubach: Colònia,Espasa de fusta,Sabates
Frederic Lloberes Brunyol: Galetes,Espasa de fusta,Sabates,Casa de nines
Paco Marlés Llofriu: Retallable,Nina morena,Espasa de fusta
Miquel Orobitg Piqueras: Mocador de coll,Nina morena,Bicicleta
Susanna Páramo Pont: Nina bebé,Jersei
Víctor Padilla López: Televisor,Capsa de bombons,Guants,Joc de taula,Cadireta
Pepa Manyé Jara: Cowboy
Pitu Pi Tió: Televisor
Candela Jaques Palau: Ràdio
Mònica Piqueras Hosta: Conillet rosa,Capsa de bombons,Cotxe,Joc de taula,Cowboy
Miquel Alemany Llort: Torró,Jersei
Helena Taberner Palop: Corbata,Jersei,Nina bebé,Calendari,Gorro,Disc de música
Sam Montroig Magrinyà: Bufanda,Capsa de bombons
Pepa Lloris Albiol: Sabons,Jersei,Ràdio,Espasa de fusta,Arc i fletxes,Capsa de bombons
Alfons Marsany Malla: Galetes,Llibre,Joc de taula
Frances Laborda Maluquer: Llibre,Tren
Helena Petit Iglesias: Escacs,Joc de taula
Ot Mallafré Marsà: Escacs,Sabons,Casa de nines,Cadireta
Antonia Morillo Roure: Mocador de coll,Guerrer amb espasa,Capsa de bombons,Manta,Joc de taula
Joan Josep Iglesias Morral: Mocador de coll,Estoig,Conillet rosa,Ràdio
Pitu Marcet Pericas: Espasa de fusta
Iu Oliveras Palomera: Sabates,Jersei
Charly Jara Fernàndez: Bicicleta,Arc i fletxes
Max Montió Marata: Cotxe elèctric
Carles Ibarra Guevara: Llibre,Llibreta,Conillet rosa
Helena Mundó Parer: Colònia,Mitjons,Cotxe
Joan Jodar Montràs: Escacs,Llapissos,Retallable,Corbata,Casa de nines
Daniel Llatser Mundó: Ulleres de sol,Bicicleta
Felicitat Paula Not: Escacs
Pere Mercadal Masolivé: Biberó,Cotxe,Bicicleta
Susanna Marlés Jornet: Sabons,Manta,Bossa de mà,Espasa de fusta,Arc i fletxes,Capsa de bombons
Diego Mitjavila Huguet: Nina bebé
Diego Mula Llach: Escacs,Estoig,Jersei
Ernest Moya Mascarell: Caramels,Corbata,Mòbil,Espasa de fusta,Bufanda,Ulleres de sol
Susanna Maginet March: Ulleres de sol,Guerrer amb espasa,Torró,Nina morena
Pep Piñol Matamala: Bicicleta
Mònica Pericas Taberner: Corbata,Casa de nines,Retallable,Nina rossa,Cadireta,Llibreta
Baldiri Ortega Mercadal: Televisor,Guants,Casa de nines
Zeus Molas Bru: Nina morena,Mitjons,Sabates,Cowboy
Frederic Mascarell Bru: Mocador de coll,Llibreta,Ordinador,Espasa de fusta,Tren
Lluis Guvern Mach: Retallable,Gorro,Capsa de bombons,Joc de taula,Casa de nines
Pere Maldonado Parer: Torró
Paco Alba Perez: Sabates,Puzzle,Manta,Conillet rosa,Os de peluix
Antonia Marlés Ingla: Escacs,Mocador de coll,Colònia
Met Llofriu Pinot: Retallable,Mitxons,Jaqueta,Calendari,Cadireta
Diego López Vilamoll: Retallable,Llibre,Guants,Disc de música,Arc i fletxes
Susanna Ingla Murga: Biberó,Mitjons,Sabates,Joc de taula,Calendari,Escacs
David Bru Paret: Torró,Tren,Guants,Arc i fletxes
Xavier Agulla Lara: Rellotge,Manta,Bicicleta,Conillet rosa,Arc i fletxes,Ulleres de sol
Joan Josep Miravet Llanet: Sabons,Sabates
Joan Maldonado Moron: Biberó,Jaqueta,Arc i fletxes,Bicicleta,Calendari,Cadireta
Víctor Isanta Aubert: Escacs,Joc de taula
Marta Pi Llanet: Gorro,Mitxons,Arc i fletxes
Sònia Miravet Codina: Mocador de coll,Caramels,Cowboy,Sabates,Llapissos
Candela Terrats Llanet: Bossa de mà,Torró,Jaqueta,Mitxons
Daniel Pou Icart: Nina bebé,Caramels,Mitxons,Sabons
Joaquim Petit Montió: Conillet rosa,Cotxe
Joaquim Bru Guardiola: Corbata
Pol Navajas Alemany: Televisor,Mocador de coll,Manta,Mitjons,Nina bebé
Marta Picanyol Marsany: Caramels,Guants,Jersei,Arc i fletxes
Pepa Malla Parra: Llapissos,Cowboy,Nina morena,Biberó
Iu Lacalle Roure: Llibreta,Guants,Jersei
Capsa de bombons,Puzzle,Sabates,Nina bebé,Joc de taula,Cadireta,Escacs,Ulleres de sol,Colònia,Ordinador
